{
"BackCround":{
"backCround_type":1,"bottom_type":2,"skill_type":0},"level":204,"mode":1,"LevelType":{
"Key":"@","Type":1,"Number":8},"Star":{
"star1":120,"star2":23540,"star3":41230},"Gang":{
"Gang1":0,"Gang2":0,"Gang3":1,"Gang4":1,"Gang5":1},"ReadyBubble":{
"R1":0,"R2":0,"R3":0,"R4":0},"BallNumber":35,"TimeLimit":0,"ObjChance":[{
"Key":"C","P":5},{
"Key":"A","P":5},{
"Key":"B","P":5},{
"Key":"E","P":5},{
"Key":"D","P":5}],"top":[],"bubble
":[{
"key":"I","x":0,"y":5,"s":1,"i":0},{
"key":"BJ","x":0,"y":7,"s":1,"i":0},{
"key":"I","x":0,"y":10,"s":1,"i":0},{
"key":"I","x":1,"y":4,"s":1,"i":0},{
"key":"H","x":1,"y":6,"s":1,"i":0},{
"key":"H","x":1,"y":7,"s":1,"i":0},{
"key":"I","x":2,"y":4,"s":1,"i":0},{
"key":"H","x":2,"y":6,"s":1,"i":0},{
"key":"CJ","x":2,"y":7,"s":1,"i":0},{
"key":"H","x":2,"y":8,"s":1,"i":0},{
"key":"K","x":3,"y":2,"s":1,"i":0},{
"key":"K","x":3,"y":3,"s":1,"i":0},{
"key":"K","x":3,"y":4,"s":1,"i":0},{
"key":"C1","x":3,"y":6,"s":1,"i":0},{
"key":"C1","x":3,"y":7,"s":1,"i":0},{
"key":"E","x":4,"y":1,"s":1,"i":0},{
"key":"B","x":4,"y":2,"s":1,"i":0},{
"key":"B","x":4,"y":3,"s":1,"i":0},{
"key":"I","x":4,"y":4,"s":1,"i":0},{
"key":"I","x":4,"y":5,"s":1,"i":0},{
"key":"H","x":4,"y":6,"s":1,"i":0},{
"key":"H","x":4,"y":7,"s":1,"i":0},{
"key":"H","x":4,"y":8,"s":1,"i":0},{
"key":"K","x":4,"y":9,"s":1,"i":0},{
"key":"E1","x":5,"y":0,"s":1,"i":0},{
"key":"H","x":5,"y":1,"s":1,"i":0},{
"key":"H","x":5,"y":2,"s":1,"i":0},{
"key":"C","x":5,"y":3,"s":1,"i":0},{
"key":"K","x":5,"y":4,"s":1,"i":0},{
"key":"H","x":5,"y":5,"s":1,"i":0},{
"key":"H","x":5,"y":6,"s":1,"i":0},{
"key":"H","x":5,"y":7,"s":1,"i":0},{
"key":"H","x":5,"y":8,"s":1,"i":0},{
"key":"K","x":5,"y":9,"s":1,"i":0},{
"key":"E","x":6,"y":1,"s":1,"i":0},{
"key":"C","x":6,"y":2,"s":1,"i":0},{
"key":"C1","x":6,"y":3,"s":1,"i":0},{
"key":"K","x":7,"y":0,"s":1,"i":0},{
"key":"BJ","x":7,"y":1,"s":1,"i":0},{
"key":"K","x":7,"y":2,"s":1,"i":0},{
"key":"A","x":7,"y":3,"s":1,"i":0},{
"key":"A","x":7,"y":4,"s":1,"i":0},{
"key":"B","x":8,"y":1,"s":1,"i":0},{
"key":"B","x":8,"y":2,"s":1,"i":0},{
"key":"A1","x":8,"y":4,"s":1,"i":0},{
"key":"K","x":9,"y":0,"s":1,"i":0},{
"key":"DJ","x":9,"y":1,"s":1,"i":0},{
"key":"K","x":9,"y":2,"s":1,"i":0},{
"key":"C","x":9,"y":3,"s":1,"i":0},{
"key":"D","x":10,"y":1,"s":1,"i":0},{
"key":"B","x":10,"y":2,"s":1,"i":0},{
"key":"B","x":10,"y":3,"s":1,"i":0},{
"key":"C","x":10,"y":4,"s":1,"i":0},{
"key":"K","x":11,"y":0,"s":1,"i":0},{
"key":"H","x":11,"y":1,"s":1,"i":0},{
"key":"H","x":11,"y":2,"s":1,"i":0},{
"key":"H","x":11,"y":3,"s":1,"i":0},{
"key":"K","x":11,"y":4,"s":1,"i":0},{
"key":"K","x":12,"y":0,"s":1,"i":0},{
"key":"H","x":12,"y":1,"s":1,"i":0},{
"key":"H","x":12,"y":2,"s":1,"i":0},{
"key":"H","x":12,"y":3,"s":1,"i":0},{
"key":"H","x":12,"y":4,"s":1,"i":0},{
"key":"K","x":12,"y":5,"s":1,"i":0},{
"key":"C","x":13,"y":0,"s":1,"i":0},{
"key":"D","x":13,"y":1,"s":1,"i":0},{
"key":"C","x":13,"y":2,"s":1,"i":0},{
"key":"C","x":13,"y":3,"s":1,"i":0},{
"key":"E","x":13,"y":4,"s":1,"i":0},{
"key":"A","x":13,"y":6,"s":1,"i":0},{
"key":"D","x":13,"y":9,"s":1,"i":0},{
"key":"C","x":14,"y":0,"s":1,"i":0},{
"key":"B","x":14,"y":1,"s":1,"i":0},{
"key":"D","x":14,"y":2,"s":1,"i":0},{
"key":"C","x":14,"y":3,"s":1,"i":0},{
"key":"E","x":14,"y":4,"s":1,"i":0},{
"key":"B","x":14,"y":5,"s":1,"i":0},{
"key":"A","x":14,"y":6,"s":1,"i":0},{
"key":"C","x":14,"y":7,"s":1,"i":0},{
"key":"C","x":14,"y":8,"s":1,"i":0},{
"key":"E","x":14,"y":9,"s":1,"i":0},{
"key":"D","x":14,"y":10,"s":1,"i":0},{
"key":"BJ","x":15,"y":0,"s":1,"i":0},{
"key":"D","x":15,"y":1,"s":1,"i":0},{
"key":"B","x":15,"y":2,"s":1,"i":0},{
"key":"J","x":15,"y":3,"s":1,"i":0},{
"key":"B","x":15,"y":4,"s":1,"i":0},{
"key":"A","x":15,"y":5,"s":1,"i":0},{
"key":"J","x":15,"y":7,"s":1,"i":0},{
"key":"EJ","x":15,"y":8,"s":1,"i":0},{
"key":"B","x":15,"y":9,"s":1,"i":0},{
"key":"E","x":16,"y":0,"s":1,"i":0},{
"key":"A","x":16,"y":1,"s":1,"i":0},{
"key":"A","x":16,"y":2,"s":1,"i":0},{
"key":"B","x":16,"y":3,"s":1,"i":0},{
"key":"E","x":16,"y":4,"s":1,"i":0},{
"key":"B","x":16,"y":5,"s":1,"i":0},{
"key":"A","x":16,"y":6,"s":1,"i":0},{
"key":"D","x":16,"y":7,"s":1,"i":0},{
"key":"D","x":16,"y":8,"s":1,"i":0},{
"key":"E","x":16,"y":9,"s":1,"i":0},{
"key":"C","x":16,"y":10,"s":1,"i":0},{
"key":"E","x":17,"y":0,"s":1,"i":0},{
"key":"C1","x":17,"y":1,"s":1,"i":0},{
"key":"A","x":17,"y":2,"s":1,"i":0},{
"key":"D","x":17,"y":3,"s":1,"i":0},{
"key":"E","x":17,"y":4,"s":1,"i":0},{
"key":"A","x":17,"y":6,"s":1,"i":0},{
"key":"C","x":17,"y":9,"s":1,"i":0},{
"key":"E","x":18,"y":0,"s":1,"i":0},{
"key":"B","x":18,"y":1,"s":1,"i":0},{
"key":"C1","x":18,"y":2,"s":1,"i":0},{
"key":"D","x":18,"y":3,"s":1,"i":0},{
"key":"K","x":18,"y":5,"s":1,"i":0},{
"key":"H","x":18,"y":6,"s":1,"i":0},{
"key":"H","x":18,"y":9,"s":1,"i":0},{
"key":"K","x":18,"y":10,"s":1,"i":0},{
"key":"B","x":19,"y":0,"s":1,"i":0},{
"key":"DJ","x":19,"y":1,"s":1,"i":0},{
"key":"B","x":19,"y":2,"s":1,"i":0},{
"key":"C","x":19,"y":3,"s":1,"i":0},{
"key":"K","x":19,"y":5,"s":1,"i":0},{
"key":"H","x":19,"y":6,"s":1,"i":0},{
"key":"I","x":19,"y":7,"s":1,"i":0},{
"key":"H","x":19,"y":8,"s":1,"i":0},{
"key":"K","x":19,"y":9,"s":1,"i":0},{
"key":"A","x":20,"y":0,"s":1,"i":0},{
"key":"D","x":20,"y":1,"s":1,"i":0},{
"key":"D","x":20,"y":2,"s":1,"i":0},{
"key":"A","x":20,"y":3,"s":1,"i":0},{
"key":"C","x":20,"y":4,"s":1,"i":0},{
"key":"A","x":21,"y":0,"s":1,"i":0},{
"key":"D","x":21,"y":1,"s":1,"i":0},{
"key":"C1","x":21,"y":2,"s":1,"i":0},{
"key":"A","x":21,"y":3,"s":1,"i":0},{
"key":"H","x":21,"y":4,"s":1,"i":0},{
"key":"C","x":22,"y":0,"s":1,"i":0},{
"key":"B","x":22,"y":1,"s":1,"i":0},{
"key":"C","x":22,"y":2,"s":1,"i":0},{
"key":"C","x":22,"y":3,"s":1,"i":0},{
"key":"H","x":22,"y":4,"s":1,"i":0},{
"key":"H","x":22,"y":5,"s":1,"i":0},{
"key":"C","x":23,"y":0,"s":1,"i":0},{
"key":"B","x":23,"y":1,"s":1,"i":0},{
"key":"CJ","x":23,"y":2,"s":1,"i":0},{
"key":"D","x":23,"y":3,"s":1,"i":0},{
"key":"H","x":23,"y":4,"s":1,"i":0},{
"key":"C","x":24,"y":0,"s":1,"i":0},{
"key":"E","x":24,"y":1,"s":1,"i":0},{
"key":"E","x":24,"y":2,"s":1,"i":0},{
"key":"D","x":24,"y":3,"s":1,"i":0},{
"key":"D","x":24,"y":4,"s":1,"i":0},{
"key":"K","x":25,"y":0,"s":1,"i":0},{
"key":"H","x":25,"y":1,"s":1,"i":0},{
"key":"K","x":25,"y":2,"s":1,"i":0},{
"key":"H","x":25,"y":3,"s":1,"i":0},{
"key":"K","x":25,"y":4,"s":1,"i":0},{
"key":"K","x":26,"y":0,"s":1,"i":0},{
"key":"H","x":26,"y":1,"s":1,"i":0},{
"key":"H","x":26,"y":4,"s":1,"i":0},{
"key":"K","x":26,"y":5,"s":1,"i":0}],"sub
":[],"down
":[],"jysub

":[]}