{
"BackCround":{
"backCround_type":1,"bottom_type":2,"skill_type":0},"level":10009,"mode":1,"LevelType":{
"Key":"@","Type":1,"Number":2},"Star":{
"star1":11111,"star2":35000,"star3":42000},"Gang":{
"Gang1":0,"Gang2":0,"Gang3":1,"Gang4":0,"Gang5":0},"BallNumber":16,"TimeLimit":0,"ObjChance":[{
"Key":"C","P":4},{
"Key":"A","P":4},{
"Key":"B","P":4},{
"Key":"E","P":4}],"top":[],"bubble
":[{
"key":"AJ","x":0,"y":0,"s":1,"i":0},{
"key":"D","x":0,"y":1,"s":1,"i":0},{
"key":"AA","x":0,"y":2,"s":1,"i":0},{
"key":"D","x":0,"y":3,"s":1,"i":0},{
"key":"AJ","x":0,"y":4,"s":1,"i":0},{
"key":"C1","x":0,"y":5,"s":1,"i":0},{
"key":"C1","x":0,"y":6,"s":1,"i":0},{
"key":"C1","x":0,"y":7,"s":1,"i":0},{
"key":"C1","x":0,"y":8,"s":1,"i":0},{
"key":"C1","x":0,"y":9,"s":1,"i":0},{
"key":"C1","x":0,"y":10,"s":1,"i":0},{
"key":"AA","x":1,"y":0,"s":1,"i":0},{
"key":"D","x":1,"y":1,"s":1,"i":0},{
"key":"D","x":1,"y":2,"s":1,"i":0},{
"key":"AA","x":1,"y":3,"s":1,"i":0},{
"key":"G","x":1,"y":4,"s":1,"i":0},{
"key":"G","x":1,"y":5,"s":1,"i":0},{
"key":"G","x":1,"y":9,"s":1,"i":0},{
"key":"D","x":2,"y":0,"s":1,"i":0},{
"key":"D","x":2,"y":1,"s":1,"i":0},{
"key":"RS","x":2,"y":2,"s":1,"i":0},{
"key":"D","x":2,"y":3,"s":1,"i":0},{
"key":"C1","x":2,"y":4,"s":1,"i":0},{
"key":"C1","x":2,"y":5,"s":1,"i":0},{
"key":"C1","x":2,"y":6,"s":1,"i":0},{
"key":"C1","x":2,"y":7,"s":1,"i":0},{
"key":"C1","x":2,"y":8,"s":1,"i":0},{
"key":"C1","x":2,"y":9,"s":1,"i":0},{
"key":"G","x":2,"y":10,"s":1,"i":0},{
"key":"E","x":3,"y":0,"s":1,"i":0},{
"key":"E","x":3,"y":1,"s":1,"i":0},{
"key":"C","x":3,"y":2,"s":1,"i":0},{
"key":"G","x":3,"y":4,"s":1,"i":0},{
"key":"G","x":3,"y":5,"s":1,"i":0},{
"key":"G","x":3,"y":9,"s":1,"i":0},{
"key":"B","x":4,"y":0,"s":1,"i":0},{
"key":"E","x":4,"y":1,"s":1,"i":0},{
"key":"C","x":4,"y":2,"s":1,"i":0},{
"key":"C1","x":4,"y":3,"s":1,"i":0},{
"key":"C1","x":4,"y":4,"s":1,"i":0},{
"key":"C1","x":4,"y":5,"s":1,"i":0},{
"key":"C1","x":4,"y":6,"s":1,"i":0},{
"key":"C1","x":4,"y":7,"s":1,"i":0},{
"key":"C1","x":4,"y":8,"s":1,"i":0},{
"key":"G","x":4,"y":9,"s":1,"i":0},{
"key":"G","x":4,"y":10,"s":1,"i":0},{
"key":"AB","x":5,"y":0,"s":1,"i":0},{
"key":"A","x":5,"y":1,"s":1,"i":0},{
"key":"G","x":5,"y":4,"s":1,"i":0},{
"key":"G","x":5,"y":5,"s":1,"i":0},{
"key":"G","x":5,"y":9,"s":1,"i":0},{
"key":"A","x":6,"y":0,"s":1,"i":0},{
"key":"AB","x":6,"y":1,"s":1,"i":0},{
"key":"@","x":6,"y":4,"s":1,"i":0},{
"key":"C1","x":6,"y":5,"s":1,"i":0},{
"key":"@","x":6,"y":6,"s":1,"i":0},{
"key":"@","x":6,"y":7,"s":1,"i":0},{
"key":"C1","x":6,"y":8,"s":1,"i":0},{
"key":"@","x":6,"y":9,"s":1,"i":0},{
"key":"H","x":6,"y":10,"s":1,"i":0},{
"key":"C","x":7,"y":0,"s":1,"i":0},{
"key":"G","x":7,"y":4,"s":1,"i":0},{
"key":"G","x":7,"y":5,"s":1,"i":0},{
"key":"C","x":7,"y":9,"s":1,"i":0},{
"key":"A","x":8,"y":0,"s":1,"i":0},{
"key":"G","x":8,"y":1,"s":1,"i":0},{
"key":"@","x":8,"y":3,"s":1,"i":0},{
"key":"C1","x":8,"y":4,"s":1,"i":0},{
"key":"@","x":8,"y":5,"s":1,"i":0},{
"key":"@","x":8,"y":6,"s":1,"i":0},{
"key":"C1","x":8,"y":7,"s":1,"i":0},{
"key":"@","x":8,"y":8,"s":1,"i":0},{
"key":"E","x":8,"y":9,"s":1,"i":0},{
"key":"C","x":8,"y":10,"s":1,"i":0},{
"key":"G","x":9,"y":0,"s":1,"i":0},{
"key":"G","x":9,"y":4,"s":1,"i":0},{
"key":"G","x":9,"y":5,"s":1,"i":0},{
"key":"A","x":9,"y":8,"s":1,"i":0},{
"key":"E","x":9,"y":9,"s":1,"i":0},{
"key":"G","x":10,"y":0,"s":1,"i":0},{
"key":"G","x":10,"y":1,"s":1,"i":0},{
"key":"@","x":10,"y":2,"s":1,"i":0},{
"key":"C1","x":10,"y":3,"s":1,"i":0},{
"key":"@","x":10,"y":4,"s":1,"i":0},{
"key":"@","x":10,"y":5,"s":1,"i":0},{
"key":"C1","x":10,"y":6,"s":1,"i":0},{
"key":"@","x":10,"y":7,"s":1,"i":0},{
"key":"K","x":10,"y":8,"s":1,"i":0},{
"key":"B","x":10,"y":9,"s":1,"i":0},{
"key":"A","x":10,"y":10,"s":1,"i":0},{
"key":"G","x":11,"y":0,"s":1,"i":0},{
"key":"G","x":11,"y":4,"s":1,"i":0},{
"key":"G","x":11,"y":5,"s":1,"i":0},{
"key":"C","x":11,"y":7,"s":1,"i":0},{
"key":"C","x":11,"y":8,"s":1,"i":0},{
"key":"B","x":11,"y":9,"s":1,"i":0},{
"key":"A","x":12,"y":0,"s":1,"i":0},{
"key":"C","x":12,"y":1,"s":1,"i":0},{
"key":"C","x":12,"y":2,"s":1,"i":0},{
"key":"@","x":12,"y":3,"s":1,"i":0},{
"key":"@","x":12,"y":4,"s":1,"i":0},{
"key":"G","x":12,"y":5,"s":1,"i":0},{
"key":"C","x":12,"y":7,"s":1,"i":0},{
"key":"A","x":12,"y":8,"s":1,"i":0},{
"key":"K","x":12,"y":9,"s":1,"i":0},{
"key":"TC","x":12,"y":10,"s":1,"i":0},{
"key":"A","x":13,"y":0,"s":1,"i":0},{
"key":"G","x":13,"y":4,"s":1,"i":0},{
"key":"G","x":13,"y":5,"s":1,"i":0},{
"key":"B","x":13,"y":6,"s":1,"i":0},{
"key":"K","x":13,"y":7,"s":1,"i":0},{
"key":"A","x":13,"y":8,"s":1,"i":0},{
"key":"E","x":13,"y":9,"s":1,"i":0},{
"key":"@","x":14,"y":0,"s":1,"i":0},{
"key":"E","x":14,"y":1,"s":1,"i":0},{
"key":"@","x":14,"y":2,"s":1,"i":0},{
"key":"@","x":14,"y":3,"s":1,"i":0},{
"key":"G","x":14,"y":5,"s":1,"i":0},{
"key":"K","x":14,"y":6,"s":1,"i":0},{
"key":"B","x":14,"y":7,"s":1,"i":0},{
"key":"B","x":14,"y":8,"s":1,"i":0},{
"key":"E","x":14,"y":9,"s":1,"i":0},{
"key":"K","x":14,"y":10,"s":1,"i":0},{
"key":"B","x":15,"y":0,"s":1,"i":0},{
"key":"E","x":15,"y":1,"s":1,"i":0},{
"key":"G","x":15,"y":4,"s":1,"i":0},{
"key":"G","x":15,"y":5,"s":1,"i":0},{
"key":"G","x":15,"y":9,"s":1,"i":0},{
"key":"B","x":16,"y":0,"s":1,"i":0},{
"key":"D","x":16,"y":1,"s":1,"i":0},{
"key":"D","x":16,"y":2,"s":1,"i":0},{
"key":"D","x":16,"y":3,"s":1,"i":0},{
"key":"@","x":16,"y":4,"s":1,"i":0},{
"key":"@","x":16,"y":5,"s":1,"i":0},{
"key":"@","x":16,"y":6,"s":1,"i":0},{
"key":"@","x":16,"y":7,"s":1,"i":0},{
"key":"@","x":16,"y":8,"s":1,"i":0},{
"key":"G","x":16,"y":9,"s":1,"i":0},{
"key":"G","x":16,"y":10,"s":1,"i":0},{
"key":"D","x":17,"y":0,"s":1,"i":0},{
"key":"D","x":17,"y":1,"s":1,"i":0},{
"key":"D","x":17,"y":2,"s":1,"i":0},{
"key":"G","x":17,"y":4,"s":1,"i":0},{
"key":"G","x":17,"y":5,"s":1,"i":0},{
"key":"G","x":17,"y":9,"s":1,"i":0},{
"key":"D","x":18,"y":0,"s":1,"i":0},{
"key":"D","x":18,"y":1,"s":1,"i":0},{
"key":"RS","x":18,"y":2,"s":1,"i":0},{
"key":"D","x":18,"y":3,"s":1,"i":0},{
"key":"D","x":18,"y":4,"s":1,"i":0},{
"key":"@","x":18,"y":5,"s":1,"i":0},{
"key":"@","x":18,"y":6,"s":1,"i":0},{
"key":"@","x":18,"y":7,"s":1,"i":0},{
"key":"@","x":18,"y":8,"s":1,"i":0},{
"key":"@","x":18,"y":9,"s":1,"i":0},{
"key":"G","x":18,"y":10,"s":1,"i":0},{
"key":"D","x":19,"y":0,"s":1,"i":0},{
"key":"C","x":19,"y":1,"s":1,"i":0},{
"key":"A","x":19,"y":2,"s":1,"i":0},{
"key":"B","x":19,"y":3,"s":1,"i":0},{
"key":"G","x":19,"y":4,"s":1,"i":0},{
"key":"G","x":19,"y":5,"s":1,"i":0},{
"key":"G","x":19,"y":9,"s":1,"i":0},{
"key":"D","x":20,"y":0,"s":1,"i":0},{
"key":"D","x":20,"y":1,"s":1,"i":0},{
"key":"C","x":20,"y":2,"s":1,"i":0},{
"key":"A","x":20,"y":3,"s":1,"i":0},{
"key":"B","x":20,"y":4,"s":1,"i":0},{
"key":"A","x":20,"y":5,"s":1,"i":0},{
"key":"A","x":20,"y":6,"s":1,"i":0},{
"key":"AE","x":20,"y":7,"s":1,"i":0},{
"key":"AE","x":20,"y":8,"s":1,"i":0},{
"key":"C","x":20,"y":9,"s":1,"i":0},{
"key":"C","x":20,"y":10,"s":1,"i":0}],"sub
":[]}