{
"BackCround":{
"backCround_type":1,"bottom_type":2,"skill_type":0},"level":395,"mode":1,"LevelType":{
"Key":"@","Type":1,"Number":4},"Star":{
"star1":120,"star2":40000,"star3":48000},"Gang":{
"Gang1":0,"Gang2":0,"Gang3":0,"Gang4":1,"Gang5":1},"ReadyBubble":{
"R1":0,"R2":0,"R3":0,"R4":0},"BallNumber":30,"TimeLimit":0,"ObjChance":[{
"Key":"C","P":4},{
"Key":"A","P":4},{
"Key":"B","P":4},{
"Key":"E","P":4},{
"Key":"D","P":4}],"top":[],"bubble
":[{
"key":"@","x":0,"y":1,"s":1,"i":0},{
"key":"AJ","x":0,"y":2,"s":1,"i":0},{
"key":"@","x":0,"y":3,"s":1,"i":0},{
"key":"@","x":0,"y":4,"s":1,"i":0},{
"key":"CJ","x":0,"y":5,"s":1,"i":0},{
"key":"@","x":0,"y":6,"s":1,"i":0},{
"key":"BJ","x":0,"y":7,"s":1,"i":0},{
"key":"DJ","x":0,"y":8,"s":1,"i":0},{
"key":"@","x":0,"y":9,"s":1,"i":0},{
"key":"A1","x":1,"y":1,"s":1,"i":0},{
"key":"A1","x":1,"y":2,"s":1,"i":0},{
"key":"B","x":1,"y":3,"s":1,"i":0},{
"key":"A1","x":1,"y":4,"s":1,"i":0},{
"key":"A1","x":1,"y":5,"s":1,"i":0},{
"key":"E","x":1,"y":6,"s":1,"i":0},{
"key":"A1","x":1,"y":7,"s":1,"i":0},{
"key":"A1","x":1,"y":8,"s":1,"i":0},{
"key":"A","x":2,"y":2,"s":1,"i":0},{
"key":"E","x":2,"y":3,"s":1,"i":0},{
"key":"B","x":2,"y":4,"s":1,"i":0},{
"key":"E","x":2,"y":6,"s":1,"i":0},{
"key":"B","x":2,"y":7,"s":1,"i":0},{
"key":"D","x":2,"y":8,"s":1,"i":0},{
"key":"A1","x":3,"y":2,"s":1,"i":0},{
"key":"A1","x":3,"y":3,"s":1,"i":0},{
"key":"A1","x":3,"y":6,"s":1,"i":0},{
"key":"A1","x":3,"y":7,"s":1,"i":0},{
"key":"C1","x":4,"y":1,"s":1,"i":0},{
"key":"E","x":4,"y":3,"s":1,"i":0},{
"key":"H","x":4,"y":4,"s":1,"i":0},{
"key":"@","x":4,"y":5,"s":1,"i":0},{
"key":"H","x":4,"y":6,"s":1,"i":0},{
"key":"@","x":4,"y":7,"s":1,"i":0},{
"key":"C1","x":4,"y":9,"s":1,"i":0},{
"key":"C1","x":5,"y":0,"s":1,"i":0},{
"key":"C1","x":5,"y":1,"s":1,"i":0},{
"key":"C1","x":5,"y":2,"s":1,"i":0},{
"key":"E","x":5,"y":3,"s":1,"i":0},{
"key":"@","x":5,"y":4,"s":1,"i":0},{
"key":"D","x":5,"y":5,"s":1,"i":0},{
"key":"D","x":5,"y":6,"s":1,"i":0},{
"key":"C1","x":5,"y":7,"s":1,"i":0},{
"key":"C1","x":5,"y":8,"s":1,"i":0},{
"key":"C1","x":5,"y":9,"s":1,"i":0},{
"key":"C1","x":6,"y":0,"s":1,"i":0},{
"key":"B","x":6,"y":1,"s":1,"i":0},{
"key":"C1","x":6,"y":2,"s":1,"i":0},{
"key":"@","x":6,"y":4,"s":1,"i":0},{
"key":"B","x":6,"y":5,"s":1,"i":0},{
"key":"D","x":6,"y":6,"s":1,"i":0},{
"key":"C1","x":6,"y":8,"s":1,"i":0},{
"key":"A","x":6,"y":9,"s":1,"i":0},{
"key":"C1","x":6,"y":10,"s":1,"i":0},{
"key":"C1","x":7,"y":0,"s":1,"i":0},{
"key":"C1","x":7,"y":1,"s":1,"i":0},{
"key":"C1","x":7,"y":2,"s":1,"i":0},{
"key":"A","x":7,"y":3,"s":1,"i":0},{
"key":"A","x":7,"y":4,"s":1,"i":0},{
"key":"E","x":7,"y":5,"s":1,"i":0},{
"key":"@","x":7,"y":6,"s":1,"i":0},{
"key":"C1","x":7,"y":7,"s":1,"i":0},{
"key":"C1","x":7,"y":8,"s":1,"i":0},{
"key":"C1","x":7,"y":9,"s":1,"i":0},{
"key":"C1","x":8,"y":1,"s":1,"i":0},{
"key":"C","x":8,"y":3,"s":1,"i":0},{
"key":"H","x":8,"y":4,"s":1,"i":0},{
"key":"E","x":8,"y":5,"s":1,"i":0},{
"key":"H","x":8,"y":6,"s":1,"i":0},{
"key":"B","x":8,"y":7,"s":1,"i":0},{
"key":"C1","x":8,"y":9,"s":1,"i":0},{
"key":"@","x":9,"y":2,"s":1,"i":0},{
"key":"C","x":9,"y":3,"s":1,"i":0},{
"key":"B","x":9,"y":6,"s":1,"i":0},{
"key":"O","x":9,"y":7,"s":1,"i":0},{
"key":"B","x":10,"y":2,"s":1,"i":0},{
"key":"B","x":10,"y":3,"s":1,"i":0},{
"key":"D","x":10,"y":4,"s":1,"i":0},{
"key":"D","x":10,"y":6,"s":1,"i":0},{
"key":"D","x":10,"y":7,"s":1,"i":0},{
"key":"E","x":10,"y":8,"s":1,"i":0},{
"key":"A","x":11,"y":1,"s":1,"i":0},{
"key":"C","x":11,"y":2,"s":1,"i":0},{
"key":"D","x":11,"y":3,"s":1,"i":0},{
"key":"H","x":11,"y":4,"s":1,"i":0},{
"key":"H","x":11,"y":5,"s":1,"i":0},{
"key":"B","x":11,"y":6,"s":1,"i":0},{
"key":"@","x":11,"y":7,"s":1,"i":0},{
"key":"A","x":11,"y":8,"s":1,"i":0},{
"key":"F","x":12,"y":1,"s":1,"i":0},{
"key":"F","x":12,"y":2,"s":1,"i":0},{
"key":"F","x":12,"y":3,"s":1,"i":0},{
"key":"A","x":12,"y":4,"s":1,"i":0},{
"key":"A","x":12,"y":5,"s":1,"i":0},{
"key":"B","x":12,"y":6,"s":1,"i":0},{
"key":"F","x":12,"y":7,"s":1,"i":0},{
"key":"F","x":12,"y":8,"s":1,"i":0},{
"key":"F","x":12,"y":9,"s":1,"i":0},{
"key":"H","x":13,"y":0,"s":1,"i":0},{
"key":"H","x":13,"y":1,"s":1,"i":0},{
"key":"C","x":13,"y":2,"s":1,"i":0},{
"key":"F","x":13,"y":3,"s":1,"i":0},{
"key":"D","x":13,"y":4,"s":1,"i":0},{
"key":"@","x":13,"y":5,"s":1,"i":0},{
"key":"F","x":13,"y":6,"s":1,"i":0},{
"key":"E","x":13,"y":7,"s":1,"i":0},{
"key":"H","x":13,"y":8,"s":1,"i":0},{
"key":"H","x":13,"y":9,"s":1,"i":0},{
"key":"G","x":14,"y":2,"s":1,"i":0},{
"key":"C","x":14,"y":3,"s":1,"i":0},{
"key":"F","x":14,"y":4,"s":1,"i":0},{
"key":"D","x":14,"y":5,"s":1,"i":0},{
"key":"F","x":14,"y":6,"s":1,"i":0},{
"key":"E","x":14,"y":7,"s":1,"i":0},{
"key":"G","x":14,"y":8,"s":1,"i":0},{
"key":"E","x":15,"y":1,"s":1,"i":0},{
"key":"G","x":15,"y":2,"s":1,"i":0},{
"key":"C1","x":15,"y":3,"s":1,"i":0},{
"key":"F","x":15,"y":4,"s":1,"i":0},{
"key":"F","x":15,"y":5,"s":1,"i":0},{
"key":"C1","x":15,"y":6,"s":1,"i":0},{
"key":"G","x":15,"y":7,"s":1,"i":0},{
"key":"@","x":15,"y":8,"s":1,"i":0},{
"key":"E","x":16,"y":1,"s":1,"i":0},{
"key":"C1","x":16,"y":2,"s":1,"i":0},{
"key":"G","x":16,"y":3,"s":1,"i":0},{
"key":"D","x":16,"y":4,"s":1,"i":0},{
"key":"F","x":16,"y":5,"s":1,"i":0},{
"key":"D","x":16,"y":6,"s":1,"i":0},{
"key":"G","x":16,"y":7,"s":1,"i":0},{
"key":"C1","x":16,"y":8,"s":1,"i":0},{
"key":"A","x":16,"y":9,"s":1,"i":0},{
"key":"E","x":17,"y":0,"s":1,"i":0},{
"key":"@","x":17,"y":1,"s":1,"i":0},{
"key":"C","x":17,"y":2,"s":1,"i":0},{
"key":"G","x":17,"y":3,"s":1,"i":0},{
"key":"B","x":17,"y":4,"s":1,"i":0},{
"key":"D","x":17,"y":5,"s":1,"i":0},{
"key":"G","x":17,"y":6,"s":1,"i":0},{
"key":"B","x":17,"y":7,"s":1,"i":0},{
"key":"B","x":17,"y":8,"s":1,"i":0},{
"key":"A","x":17,"y":9,"s":1,"i":0},{
"key":"@","x":18,"y":0,"s":1,"i":0},{
"key":"B","x":18,"y":1,"s":1,"i":0},{
"key":"D","x":18,"y":2,"s":1,"i":0},{
"key":"C1","x":18,"y":3,"s":1,"i":0},{
"key":"G","x":18,"y":4,"s":1,"i":0},{
"key":"C1","x":18,"y":5,"s":1,"i":0},{
"key":"G","x":18,"y":6,"s":1,"i":0},{
"key":"D1","x":18,"y":7,"s":1,"i":0},{
"key":"E","x":18,"y":8,"s":1,"i":0},{
"key":"E","x":18,"y":9,"s":1,"i":0},{
"key":"@","x":18,"y":10,"s":1,"i":0},{
"key":"B","x":19,"y":2,"s":1,"i":0},{
"key":"D","x":19,"y":3,"s":1,"i":0},{
"key":"G","x":19,"y":4,"s":1,"i":0},{
"key":"G","x":19,"y":5,"s":1,"i":0},{
"key":"D","x":19,"y":6,"s":1,"i":0},{
"key":"@","x":19,"y":7,"s":1,"i":0},{
"key":"B","x":20,"y":2,"s":1,"i":0},{
"key":"@","x":20,"y":3,"s":1,"i":0},{
"key":"A","x":20,"y":4,"s":1,"i":0},{
"key":"G","x":20,"y":5,"s":1,"i":0},{
"key":"C","x":20,"y":6,"s":1,"i":0},{
"key":"C","x":20,"y":7,"s":1,"i":0},{
"key":"@","x":20,"y":8,"s":1,"i":0},{
"key":"@","x":21,"y":1,"s":1,"i":0},{
"key":"@","x":21,"y":2,"s":1,"i":0},{
"key":"@","x":21,"y":3,"s":1,"i":0},{
"key":"A","x":21,"y":4,"s":1,"i":0},{
"key":"C","x":21,"y":5,"s":1,"i":0},{
"key":"E","x":21,"y":6,"s":1,"i":0},{
"key":"E","x":21,"y":7,"s":1,"i":0},{
"key":"@","x":21,"y":8,"s":1,"i":0}],"sub
":[{
"key":"S","x":10,"y":2,"s":0,"i":0},{
"key":"S","x":10,"y":8,"s":0,"i":0},{
"key":"S","x":11,"y":1,"s":0,"i":0},{
"key":"S","x":11,"y":8,"s":0,"i":0},{
"key":"S","x":12,"y":4,"s":0,"i":0},{
"key":"S","x":12,"y":5,"s":0,"i":0},{
"key":"S","x":12,"y":6,"s":0,"i":0},{
"key":"S","x":13,"y":4,"s":0,"i":0},{
"key":"S","x":13,"y":5,"s":0,"i":0},{
"key":"S","x":14,"y":5,"s":0,"i":0}],"down
":[],"jysub

":[]}