{
"BackCround":{
"backCround_type":1,"bottom_type":2,"skill_type":0},"level":80003,"mode":1,"LevelType":{
"Key":"@","Type":1,"Number":5},"Star":{
"star1":120,"star2":26650,"star3":41005},"Gang":{
"Gang1":1,"Gang2":1,"Gang3":0,"Gang4":1,"Gang5":1},"ReadyBubble":{
"R1":0,"R2":0,"R3":0,"R4":0},"BallNumber":40,"TimeLimit":0,"ObjChance":[{
"Key":"C","P":5},{
"Key":"A","P":5},{
"Key":"B","P":5},{
"Key":"D","P":5}],"top":[],"bubble
":[{
"key":"H","x":0,"y":0,"s":1,"i":0},{
"key":"H","x":0,"y":1,"s":1,"i":0},{
"key":"H","x":0,"y":2,"s":1,"i":0},{
"key":"H","x":0,"y":3,"s":1,"i":0},{
"key":"H","x":0,"y":4,"s":1,"i":0},{
"key":"H","x":0,"y":6,"s":1,"i":0},{
"key":"H","x":0,"y":7,"s":1,"i":0},{
"key":"H","x":0,"y":8,"s":1,"i":0},{
"key":"H","x":0,"y":9,"s":1,"i":0},{
"key":"H","x":0,"y":10,"s":1,"i":0},{
"key":"I","x":1,"y":0,"s":1,"i":0},{
"key":"N","x":1,"y":1,"s":1,"i":0},{
"key":"N","x":1,"y":2,"s":1,"i":0},{
"key":"N","x":1,"y":3,"s":1,"i":0},{
"key":"HBoss","x":1,"y":4,"s":1,"i":1},{
"key":"HBoss","x":1,"y":5,"s":1,"i":2},{
"key":"N","x":1,"y":6,"s":1,"i":0},{
"key":"N","x":1,"y":7,"s":1,"i":0},{
"key":"N","x":1,"y":8,"s":1,"i":0},{
"key":"I","x":1,"y":9,"s":1,"i":0},{
"key":"I","x":2,"y":1,"s":1,"i":0},{
"key":"A","x":2,"y":2,"s":1,"i":0},{
"key":"C","x":2,"y":3,"s":1,"i":0},{
"key":"HBoss","x":2,"y":4,"s":1,"i":3},{
"key":"HBoss","x":2,"y":5,"s":2,"i":0},{
"key":"HBoss","x":2,"y":6,"s":1,"i":4},{
"key":"C","x":2,"y":7,"s":1,"i":0},{
"key":"A","x":2,"y":8,"s":1,"i":0},{
"key":"I","x":2,"y":9,"s":1,"i":0},{
"key":"I","x":3,"y":0,"s":1,"i":0},{
"key":"A","x":3,"y":1,"s":1,"i":0},{
"key":"C","x":3,"y":2,"s":1,"i":0},{
"key":"L","x":3,"y":3,"s":1,"i":0},{
"key":"HBoss","x":3,"y":4,"s":1,"i":5},{
"key":"HBoss","x":3,"y":5,"s":1,"i":6},{
"key":"L","x":3,"y":6,"s":1,"i":0},{
"key":"C","x":3,"y":7,"s":1,"i":0},{
"key":"A","x":3,"y":8,"s":1,"i":0},{
"key":"I","x":3,"y":9,"s":1,"i":0},{
"key":"I","x":4,"y":0,"s":1,"i":0},{
"key":"D","x":4,"y":1,"s":1,"i":0},{
"key":"C","x":4,"y":2,"s":1,"i":0},{
"key":"L","x":4,"y":3,"s":1,"i":0},{
"key":"D","x":4,"y":5,"s":1,"i":0},{
"key":"L","x":4,"y":7,"s":1,"i":0},{
"key":"C","x":4,"y":8,"s":1,"i":0},{
"key":"D","x":4,"y":9,"s":1,"i":0},{
"key":"I","x":4,"y":10,"s":1,"i":0},{
"key":"I","x":5,"y":0,"s":1,"i":0},{
"key":"D","x":5,"y":1,"s":1,"i":0},{
"key":"D","x":5,"y":2,"s":1,"i":0},{
"key":"D","x":5,"y":4,"s":1,"i":0},{
"key":"D","x":5,"y":5,"s":1,"i":0},{
"key":"D","x":5,"y":7,"s":1,"i":0},{
"key":"D","x":5,"y":8,"s":1,"i":0},{
"key":"I","x":5,"y":9,"s":1,"i":0},{
"key":"I","x":6,"y":1,"s":1,"i":0},{
"key":"A","x":6,"y":2,"s":1,"i":0},{
"key":"A","x":6,"y":4,"s":1,"i":0},{
"key":"D","x":6,"y":5,"s":1,"i":0},{
"key":"A","x":6,"y":6,"s":1,"i":0},{
"key":"A","x":6,"y":8,"s":1,"i":0},{
"key":"I","x":6,"y":9,"s":1,"i":0},{
"key":"I","x":7,"y":1,"s":1,"i":0},{
"key":"A","x":7,"y":2,"s":1,"i":0},{
"key":"A","x":7,"y":4,"s":1,"i":0},{
"key":"A","x":7,"y":5,"s":1,"i":0},{
"key":"A","x":7,"y":7,"s":1,"i":0},{
"key":"I","x":7,"y":8,"s":1,"i":0},{
"key":"B","x":8,"y":1,"s":1,"i":0},{
"key":"B","x":8,"y":2,"s":1,"i":0},{
"key":"B","x":8,"y":3,"s":1,"i":0},{
"key":"B","x":8,"y":7,"s":1,"i":0},{
"key":"B","x":8,"y":8,"s":1,"i":0},{
"key":"B","x":8,"y":9,"s":1,"i":0}],"sub
":[]}