{
"BackCround":{
"backCround_type":1,"bottom_type":2,"skill_type":0},"level":683,"mode":1,"LevelType":{
"Key":"@","Type":1,"Number":10},"Star":{
"star1":120,"star2":40000,"star3":48000},"Gang":{
"Gang1":0,"Gang2":0,"Gang3":1,"Gang4":0,"Gang5":1},"BallNumber":25,"TimeLimit":0,"ObjChance":[{
"Key":"C","P":4},{
"Key":"A","P":4},{
"Key":"B","P":4},{
"Key":"E","P":4}],"top":[],"bubble
":[{
"key":"K","x":0,"y":0,"s":1,"i":0},{
"key":"K","x":0,"y":1,"s":1,"i":0},{
"key":"C","x":0,"y":2,"s":1,"i":0},{
"key":"AJ","x":0,"y":3,"s":1,"i":0},{
"key":"B","x":0,"y":4,"s":1,"i":0},{
"key":"G","x":0,"y":5,"s":1,"i":0},{
"key":"B","x":0,"y":6,"s":1,"i":0},{
"key":"BJ","x":0,"y":7,"s":1,"i":0},{
"key":"AJ","x":0,"y":8,"s":1,"i":0},{
"key":"A","x":0,"y":9,"s":1,"i":0},{
"key":"K","x":0,"y":10,"s":1,"i":0},{
"key":"K","x":1,"y":0,"s":1,"i":0},{
"key":"AJ","x":1,"y":1,"s":1,"i":0},{
"key":"C","x":1,"y":2,"s":1,"i":0},{
"key":"B","x":1,"y":3,"s":1,"i":0},{
"key":"AJ","x":1,"y":4,"s":1,"i":0},{
"key":"G","x":1,"y":5,"s":1,"i":0},{
"key":"B","x":1,"y":6,"s":1,"i":0},{
"key":"C1","x":1,"y":7,"s":1,"i":0},{
"key":"A","x":1,"y":8,"s":1,"i":0},{
"key":"K","x":1,"y":9,"s":1,"i":0},{
"key":"K","x":2,"y":0,"s":1,"i":0},{
"key":"E","x":2,"y":1,"s":1,"i":0},{
"key":"E","x":2,"y":2,"s":1,"i":0},{
"key":"RS","x":2,"y":3,"s":1,"i":0},{
"key":"E","x":2,"y":4,"s":1,"i":0},{
"key":"E","x":2,"y":5,"s":1,"i":0},{
"key":"G","x":2,"y":6,"s":1,"i":0},{
"key":"C1","x":2,"y":7,"s":1,"i":0},{
"key":"C1","x":2,"y":8,"s":1,"i":0},{
"key":"K","x":2,"y":9,"s":1,"i":0},{
"key":"K","x":2,"y":10,"s":1,"i":0},{
"key":"K","x":3,"y":0,"s":1,"i":0},{
"key":"AJ","x":3,"y":1,"s":1,"i":0},{
"key":"B","x":3,"y":2,"s":1,"i":0},{
"key":"C","x":3,"y":3,"s":1,"i":0},{
"key":"AJ","x":3,"y":4,"s":1,"i":0},{
"key":"G","x":3,"y":5,"s":1,"i":0},{
"key":"E","x":3,"y":6,"s":1,"i":0},{
"key":"C1","x":3,"y":7,"s":1,"i":0},{
"key":"C","x":3,"y":8,"s":1,"i":0},{
"key":"K","x":3,"y":9,"s":1,"i":0},{
"key":"K","x":4,"y":0,"s":1,"i":0},{
"key":"K","x":4,"y":1,"s":1,"i":0},{
"key":"B","x":4,"y":2,"s":1,"i":0},{
"key":"AJ","x":4,"y":3,"s":1,"i":0},{
"key":"C","x":4,"y":4,"s":1,"i":0},{
"key":"G","x":4,"y":5,"s":1,"i":0},{
"key":"E","x":4,"y":6,"s":1,"i":0},{
"key":"EJ","x":4,"y":7,"s":1,"i":0},{
"key":"CJ","x":4,"y":8,"s":1,"i":0},{
"key":"C","x":4,"y":9,"s":1,"i":0},{
"key":"K","x":4,"y":10,"s":1,"i":0},{
"key":"H","x":5,"y":3,"s":1,"i":0},{
"key":"H","x":5,"y":4,"s":1,"i":0},{
"key":"H","x":5,"y":5,"s":1,"i":0},{
"key":"H","x":5,"y":6,"s":1,"i":0},{
"key":"K","x":6,"y":0,"s":1,"i":0},{
"key":"@","x":6,"y":1,"s":1,"i":0},{
"key":"C1","x":6,"y":2,"s":1,"i":0},{
"key":"C1","x":6,"y":3,"s":1,"i":0},{
"key":"@","x":6,"y":4,"s":1,"i":0},{
"key":"G","x":6,"y":5,"s":1,"i":0},{
"key":"@","x":6,"y":6,"s":1,"i":0},{
"key":"C1","x":6,"y":7,"s":1,"i":0},{
"key":"@","x":6,"y":8,"s":1,"i":0},{
"key":"K","x":6,"y":9,"s":1,"i":0},{
"key":"K","x":6,"y":10,"s":1,"i":0},{
"key":"K","x":7,"y":0,"s":1,"i":0},{
"key":"@","x":7,"y":1,"s":1,"i":0},{
"key":"C1","x":7,"y":2,"s":1,"i":0},{
"key":"@","x":7,"y":3,"s":1,"i":0},{
"key":"G","x":7,"y":4,"s":1,"i":0},{
"key":"C1","x":7,"y":5,"s":1,"i":0},{
"key":"@","x":7,"y":6,"s":1,"i":0},{
"key":"@","x":7,"y":7,"s":1,"i":0},{
"key":"C1","x":7,"y":8,"s":1,"i":0},{
"key":"K","x":7,"y":9,"s":1,"i":0},{
"key":"K","x":8,"y":0,"s":1,"i":0},{
"key":"K","x":8,"y":1,"s":1,"i":0},{
"key":"@","x":8,"y":2,"s":1,"i":0},{
"key":"@","x":8,"y":3,"s":1,"i":0},{
"key":"G","x":8,"y":4,"s":1,"i":0},{
"key":"@","x":8,"y":5,"s":1,"i":0},{
"key":"@","x":8,"y":6,"s":1,"i":0},{
"key":"RS","x":8,"y":7,"s":1,"i":0},{
"key":"@","x":8,"y":8,"s":1,"i":0},{
"key":"@","x":8,"y":9,"s":1,"i":0},{
"key":"K","x":8,"y":10,"s":1,"i":0},{
"key":"K","x":9,"y":0,"s":1,"i":0},{
"key":"@","x":9,"y":1,"s":1,"i":0},{
"key":"C1","x":9,"y":2,"s":1,"i":0},{
"key":"@","x":9,"y":3,"s":1,"i":0},{
"key":"G","x":9,"y":4,"s":1,"i":0},{
"key":"C1","x":9,"y":5,"s":1,"i":0},{
"key":"@","x":9,"y":6,"s":1,"i":0},{
"key":"@","x":9,"y":7,"s":1,"i":0},{
"key":"C1","x":9,"y":8,"s":1,"i":0},{
"key":"K","x":9,"y":9,"s":1,"i":0},{
"key":"K","x":10,"y":0,"s":1,"i":0},{
"key":"@","x":10,"y":1,"s":1,"i":0},{
"key":"C1","x":10,"y":2,"s":1,"i":0},{
"key":"C1","x":10,"y":3,"s":1,"i":0},{
"key":"@","x":10,"y":4,"s":1,"i":0},{
"key":"G","x":10,"y":5,"s":1,"i":0},{
"key":"@","x":10,"y":6,"s":1,"i":0},{
"key":"C1","x":10,"y":7,"s":1,"i":0},{
"key":"@","x":10,"y":8,"s":1,"i":0},{
"key":"K","x":10,"y":9,"s":1,"i":0},{
"key":"K","x":10,"y":10,"s":1,"i":0},{
"key":"H","x":11,"y":3,"s":1,"i":0},{
"key":"H","x":11,"y":4,"s":1,"i":0},{
"key":"H","x":11,"y":5,"s":1,"i":0},{
"key":"H","x":11,"y":6,"s":1,"i":0},{
"key":"K","x":12,"y":0,"s":1,"i":0},{
"key":"K","x":12,"y":1,"s":1,"i":0},{
"key":"A","x":12,"y":2,"s":1,"i":0},{
"key":"C","x":12,"y":3,"s":1,"i":0},{
"key":"C","x":12,"y":4,"s":1,"i":0},{
"key":"G","x":12,"y":5,"s":1,"i":0},{
"key":"A","x":12,"y":6,"s":1,"i":0},{
"key":"B","x":12,"y":7,"s":1,"i":0},{
"key":"B","x":12,"y":8,"s":1,"i":0},{
"key":"C","x":12,"y":9,"s":1,"i":0},{
"key":"K","x":12,"y":10,"s":1,"i":0},{
"key":"K","x":13,"y":0,"s":1,"i":0},{
"key":"E","x":13,"y":1,"s":1,"i":0},{
"key":"E","x":13,"y":2,"s":1,"i":0},{
"key":"B","x":13,"y":3,"s":1,"i":0},{
"key":"B","x":13,"y":4,"s":1,"i":0},{
"key":"G","x":13,"y":5,"s":1,"i":0},{
"key":"A","x":13,"y":6,"s":1,"i":0},{
"key":"E","x":13,"y":7,"s":1,"i":0},{
"key":"C","x":13,"y":8,"s":1,"i":0},{
"key":"K","x":13,"y":9,"s":1,"i":0},{
"key":"K","x":14,"y":0,"s":1,"i":0},{
"key":"A","x":14,"y":1,"s":1,"i":0},{
"key":"C","x":14,"y":2,"s":1,"i":0},{
"key":"B","x":14,"y":3,"s":1,"i":0},{
"key":"A","x":14,"y":4,"s":1,"i":0},{
"key":"B","x":14,"y":5,"s":1,"i":0},{
"key":"G","x":14,"y":6,"s":1,"i":0},{
"key":"B","x":14,"y":7,"s":1,"i":0},{
"key":"E","x":14,"y":8,"s":1,"i":0},{
"key":"K","x":14,"y":9,"s":1,"i":0},{
"key":"K","x":14,"y":10,"s":1,"i":0},{
"key":"K","x":15,"y":0,"s":1,"i":0},{
"key":"B","x":15,"y":1,"s":1,"i":0},{
"key":"C","x":15,"y":2,"s":1,"i":0},{
"key":"E","x":15,"y":3,"s":1,"i":0},{
"key":"A","x":15,"y":4,"s":1,"i":0},{
"key":"G","x":15,"y":5,"s":1,"i":0},{
"key":"B","x":15,"y":6,"s":1,"i":0},{
"key":"C","x":15,"y":7,"s":1,"i":0},{
"key":"A","x":15,"y":8,"s":1,"i":0},{
"key":"K","x":15,"y":9,"s":1,"i":0},{
"key":"K","x":16,"y":0,"s":1,"i":0},{
"key":"K","x":16,"y":1,"s":1,"i":0},{
"key":"B","x":16,"y":2,"s":1,"i":0},{
"key":"E","x":16,"y":3,"s":1,"i":0},{
"key":"B","x":16,"y":4,"s":1,"i":0},{
"key":"G","x":16,"y":5,"s":1,"i":0},{
"key":"E","x":16,"y":6,"s":1,"i":0},{
"key":"C","x":16,"y":7,"s":1,"i":0},{
"key":"E","x":16,"y":8,"s":1,"i":0},{
"key":"A","x":16,"y":9,"s":1,"i":0},{
"key":"K","x":16,"y":10,"s":1,"i":0},{
"key":"H","x":17,"y":3,"s":1,"i":0},{
"key":"H","x":17,"y":4,"s":1,"i":0},{
"key":"H","x":17,"y":5,"s":1,"i":0},{
"key":"H","x":17,"y":6,"s":1,"i":0},{
"key":"K","x":18,"y":0,"s":1,"i":0},{
"key":"A","x":18,"y":1,"s":1,"i":0},{
"key":"A","x":18,"y":2,"s":1,"i":0},{
"key":"B","x":18,"y":3,"s":1,"i":0},{
"key":"B","x":18,"y":4,"s":1,"i":0},{
"key":"G","x":18,"y":5,"s":1,"i":0},{
"key":"E","x":18,"y":6,"s":1,"i":0},{
"key":"A","x":18,"y":7,"s":1,"i":0},{
"key":"A","x":18,"y":8,"s":1,"i":0},{
"key":"K","x":18,"y":9,"s":1,"i":0},{
"key":"K","x":18,"y":10,"s":1,"i":0},{
"key":"K","x":19,"y":0,"s":1,"i":0},{
"key":"E","x":19,"y":1,"s":1,"i":0},{
"key":"F","x":19,"y":2,"s":1,"i":0},{
"key":"C","x":19,"y":3,"s":1,"i":0},{
"key":"G","x":19,"y":4,"s":1,"i":0},{
"key":"E","x":19,"y":5,"s":1,"i":0},{
"key":"C","x":19,"y":6,"s":1,"i":0},{
"key":"C","x":19,"y":7,"s":1,"i":0},{
"key":"E","x":19,"y":8,"s":1,"i":0},{
"key":"K","x":19,"y":9,"s":1,"i":0},{
"key":"K","x":20,"y":0,"s":1,"i":0},{
"key":"K","x":20,"y":1,"s":1,"i":0},{
"key":"E","x":20,"y":2,"s":1,"i":0},{
"key":"C","x":20,"y":3,"s":1,"i":0},{
"key":"G","x":20,"y":4,"s":1,"i":0},{
"key":"A","x":20,"y":5,"s":1,"i":0},{
"key":"B","x":20,"y":6,"s":1,"i":0},{
"key":"F","x":20,"y":7,"s":1,"i":0},{
"key":"A","x":20,"y":8,"s":1,"i":0},{
"key":"E","x":20,"y":9,"s":1,"i":0},{
"key":"K","x":20,"y":10,"s":1,"i":0},{
"key":"K","x":21,"y":0,"s":1,"i":0},{
"key":"A","x":21,"y":1,"s":1,"i":0},{
"key":"F","x":21,"y":2,"s":1,"i":0},{
"key":"E","x":21,"y":3,"s":1,"i":0},{
"key":"G","x":21,"y":4,"s":1,"i":0},{
"key":"A","x":21,"y":5,"s":1,"i":0},{
"key":"B","x":21,"y":6,"s":1,"i":0},{
"key":"A","x":21,"y":7,"s":1,"i":0},{
"key":"B","x":21,"y":8,"s":1,"i":0},{
"key":"K","x":21,"y":9,"s":1,"i":0},{
"key":"K","x":22,"y":0,"s":1,"i":0},{
"key":"A","x":22,"y":1,"s":1,"i":0},{
"key":"B","x":22,"y":2,"s":1,"i":0},{
"key":"B","x":22,"y":3,"s":1,"i":0},{
"key":"E","x":22,"y":4,"s":1,"i":0},{
"key":"G","x":22,"y":5,"s":1,"i":0},{
"key":"C","x":22,"y":6,"s":1,"i":0},{
"key":"C","x":22,"y":7,"s":1,"i":0},{
"key":"B","x":22,"y":8,"s":1,"i":0},{
"key":"K","x":22,"y":9,"s":1,"i":0},{
"key":"K","x":22,"y":10,"s":1,"i":0}],"sub
":[{
"key":"L","x":13,"y":1,"s":0,"i":0},{
"key":"L","x":13,"y":2,"s":0,"i":0},{
"key":"Suo","x":13,"y":3,"s":0,"i":0},{
"key":"L","x":13,"y":4,"s":0,"i":0},{
"key":"L","x":13,"y":6,"s":0,"i":0},{
"key":"Suo","x":13,"y":7,"s":0,"i":0},{
"key":"L","x":13,"y":8,"s":0,"i":0},{
"key":"L","x":16,"y":2,"s":0,"i":0},{
"key":"Suo","x":16,"y":3,"s":0,"i":0},{
"key":"L","x":16,"y":4,"s":0,"i":0},{
"key":"L","x":16,"y":6,"s":0,"i":0},{
"key":"Suo","x":16,"y":7,"s":0,"i":0},{
"key":"L","x":16,"y":8,"s":0,"i":0},{
"key":"L","x":16,"y":9,"s":0,"i":0},{
"key":"S","x":18,"y":1,"s":0,"i":0},{
"key":"S","x":18,"y":4,"s":0,"i":0},{
"key":"S","x":19,"y":1,"s":0,"i":0},{
"key":"S","x":19,"y":3,"s":0,"i":0},{
"key":"S","x":19,"y":6,"s":0,"i":0},{
"key":"S","x":19,"y":7,"s":0,"i":0},{
"key":"S","x":20,"y":2,"s":0,"i":0},{
"key":"S","x":20,"y":3,"s":0,"i":0},{
"key":"S","x":20,"y":6,"s":0,"i":0},{
"key":"S","x":20,"y":8,"s":0,"i":0},{
"key":"S","x":21,"y":1,"s":0,"i":0},{
"key":"S","x":21,"y":3,"s":0,"i":0},{
"key":"S","x":21,"y":6,"s":0,"i":0},{
"key":"S","x":21,"y":7,"s":0,"i":0},{
"key":"S","x":22,"y":1,"s":0,"i":0},{
"key":"S","x":22,"y":4,"s":0,"i":0}]}