{
"BackCround":{
"backCround_type":1,"bottom_type":2,"skill_type":0},"level":490,"mode":1,"LevelType":{
"Key":"@","Type":1,"Number":6},"Star":{
"star1":120,"star2":28888,"star3":32000},"Gang":{
"Gang1":0,"Gang2":0,"Gang3":1,"Gang4":1,"Gang5":0},"ReadyBubble":{
"R1":0,"R2":0,"R3":0,"R4":0},"BallNumber":40,"TimeLimit":0,"ObjChance":[{
"Key":"C","P":4},{
"Key":"A","P":4},{
"Key":"B","P":4},{
"Key":"E","P":4},{
"Key":"D","P":4}],"top":[],"bubble
":[{
"key":"CJ","x":0,"y":0,"s":1,"i":0},{
"key":"AJ","x":0,"y":2,"s":1,"i":0},{
"key":"DJ","x":0,"y":4,"s":1,"i":0},{
"key":"H","x":0,"y":5,"s":1,"i":0},{
"key":"EJ","x":0,"y":6,"s":1,"i":0},{
"key":"EJ","x":0,"y":8,"s":1,"i":0},{
"key":"BJ","x":0,"y":10,"s":1,"i":0},{
"key":"C","x":1,"y":0,"s":1,"i":0},{
"key":"A","x":1,"y":2,"s":1,"i":0},{
"key":"D","x":1,"y":4,"s":1,"i":0},{
"key":"B","x":1,"y":5,"s":1,"i":0},{
"key":"C","x":1,"y":7,"s":1,"i":0},{
"key":"B","x":1,"y":9,"s":1,"i":0},{
"key":"A","x":2,"y":0,"s":1,"i":0},{
"key":"B","x":2,"y":2,"s":1,"i":0},{
"key":"E","x":2,"y":4,"s":1,"i":0},{
"key":"H","x":2,"y":5,"s":1,"i":0},{
"key":"C","x":2,"y":6,"s":1,"i":0},{
"key":"E","x":2,"y":8,"s":1,"i":0},{
"key":"A","x":2,"y":10,"s":1,"i":0},{
"key":"A","x":3,"y":0,"s":1,"i":0},{
"key":"B","x":3,"y":2,"s":1,"i":0},{
"key":"B","x":3,"y":4,"s":1,"i":0},{
"key":"C","x":3,"y":5,"s":1,"i":0},{
"key":"B","x":3,"y":7,"s":1,"i":0},{
"key":"E","x":3,"y":9,"s":1,"i":0},{
"key":"C","x":4,"y":0,"s":1,"i":0},{
"key":"C","x":4,"y":2,"s":1,"i":0},{
"key":"D","x":4,"y":4,"s":1,"i":0},{
"key":"H","x":4,"y":5,"s":1,"i":0},{
"key":"E","x":4,"y":6,"s":1,"i":0},{
"key":"A","x":4,"y":8,"s":1,"i":0},{
"key":"B","x":4,"y":10,"s":1,"i":0},{
"key":"@","x":5,"y":0,"s":1,"i":0},{
"key":"D","x":5,"y":2,"s":1,"i":0},{
"key":"A","x":5,"y":4,"s":1,"i":0},{
"key":"E","x":5,"y":5,"s":1,"i":0},{
"key":"A","x":5,"y":7,"s":1,"i":0},{
"key":"C","x":5,"y":9,"s":1,"i":0},{
"key":"@","x":6,"y":0,"s":1,"i":0},{
"key":"E","x":6,"y":2,"s":1,"i":0},{
"key":"E","x":6,"y":4,"s":1,"i":0},{
"key":"H","x":6,"y":5,"s":1,"i":0},{
"key":"B","x":6,"y":6,"s":1,"i":0},{
"key":"E","x":6,"y":8,"s":1,"i":0},{
"key":"C","x":6,"y":10,"s":1,"i":0},{
"key":"@","x":7,"y":0,"s":1,"i":0},{
"key":"B","x":7,"y":2,"s":1,"i":0},{
"key":"C","x":7,"y":4,"s":1,"i":0},{
"key":"D","x":7,"y":5,"s":1,"i":0},{
"key":"C","x":7,"y":7,"s":1,"i":0},{
"key":"E","x":7,"y":9,"s":1,"i":0},{
"key":"@","x":8,"y":0,"s":1,"i":0},{
"key":"C","x":8,"y":2,"s":1,"i":0},{
"key":"A","x":8,"y":4,"s":1,"i":0},{
"key":"H","x":8,"y":5,"s":1,"i":0},{
"key":"D","x":8,"y":6,"s":1,"i":0},{
"key":"B","x":8,"y":8,"s":1,"i":0},{
"key":"C","x":8,"y":10,"s":1,"i":0},{
"key":"@","x":9,"y":0,"s":1,"i":0},{
"key":"C","x":9,"y":2,"s":1,"i":0},{
"key":"BBB","x":9,"y":4,"s":1,"i":0},{
"key":"BBB","x":9,"y":5,"s":1,"i":0},{
"key":"B","x":9,"y":7,"s":1,"i":0},{
"key":"D","x":9,"y":9,"s":1,"i":0},{
"key":"O","x":10,"y":0,"s":1,"i":0},{
"key":"D","x":10,"y":2,"s":1,"i":0},{
"key":"A","x":10,"y":4,"s":1,"i":0},{
"key":"H","x":10,"y":5,"s":1,"i":0},{
"key":"E","x":10,"y":6,"s":1,"i":0},{
"key":"D","x":10,"y":8,"s":1,"i":0},{
"key":"B","x":10,"y":10,"s":1,"i":0},{
"key":"E","x":11,"y":0,"s":1,"i":0},{
"key":"D","x":11,"y":2,"s":1,"i":0},{
"key":"B","x":11,"y":4,"s":1,"i":0},{
"key":"E","x":11,"y":5,"s":1,"i":0},{
"key":"C","x":11,"y":7,"s":1,"i":0},{
"key":"A","x":11,"y":9,"s":1,"i":0},{
"key":"E","x":12,"y":0,"s":1,"i":0},{
"key":"A","x":12,"y":2,"s":1,"i":0},{
"key":"B","x":12,"y":4,"s":1,"i":0},{
"key":"H","x":12,"y":5,"s":1,"i":0},{
"key":"C","x":12,"y":6,"s":1,"i":0},{
"key":"B","x":12,"y":8,"s":1,"i":0},{
"key":"A","x":12,"y":10,"s":1,"i":0},{
"key":"@","x":13,"y":0,"s":1,"i":0},{
"key":"A","x":13,"y":2,"s":1,"i":0},{
"key":"D","x":13,"y":4,"s":1,"i":0},{
"key":"D","x":13,"y":5,"s":1,"i":0},{
"key":"E","x":13,"y":7,"s":1,"i":0},{
"key":"E","x":13,"y":9,"s":1,"i":0},{
"key":"C","x":14,"y":0,"s":1,"i":0},{
"key":"C","x":14,"y":2,"s":1,"i":0},{
"key":"E","x":14,"y":4,"s":1,"i":0},{
"key":"H","x":14,"y":5,"s":1,"i":0},{
"key":"A","x":14,"y":6,"s":1,"i":0},{
"key":"D","x":14,"y":8,"s":1,"i":0},{
"key":"B","x":14,"y":10,"s":1,"i":0},{
"key":"B","x":15,"y":0,"s":1,"i":0},{
"key":"B","x":15,"y":2,"s":1,"i":0},{
"key":"E","x":15,"y":4,"s":1,"i":0},{
"key":"A","x":15,"y":5,"s":1,"i":0},{
"key":"D","x":15,"y":7,"s":1,"i":0},{
"key":"A","x":15,"y":9,"s":1,"i":0},{
"key":"B","x":16,"y":0,"s":1,"i":0},{
"key":"D","x":16,"y":2,"s":1,"i":0},{
"key":"C","x":16,"y":4,"s":1,"i":0},{
"key":"H","x":16,"y":5,"s":1,"i":0},{
"key":"B","x":16,"y":6,"s":1,"i":0},{
"key":"B","x":16,"y":8,"s":1,"i":0},{
"key":"A","x":16,"y":10,"s":1,"i":0},{
"key":"C","x":17,"y":0,"s":1,"i":0},{
"key":"D","x":17,"y":2,"s":1,"i":0},{
"key":"C","x":17,"y":4,"s":1,"i":0},{
"key":"B","x":17,"y":5,"s":1,"i":0},{
"key":"A","x":17,"y":7,"s":1,"i":0},{
"key":"C","x":17,"y":9,"s":1,"i":0},{
"key":"C","x":18,"y":0,"s":1,"i":0},{
"key":"A","x":18,"y":2,"s":1,"i":0},{
"key":"A","x":18,"y":4,"s":1,"i":0},{
"key":"H","x":18,"y":5,"s":1,"i":0},{
"key":"D","x":18,"y":6,"s":1,"i":0},{
"key":"E","x":18,"y":8,"s":1,"i":0},{
"key":"C","x":18,"y":10,"s":1,"i":0},{
"key":"B","x":19,"y":0,"s":1,"i":0},{
"key":"E","x":19,"y":2,"s":1,"i":0},{
"key":"E","x":19,"y":4,"s":1,"i":0},{
"key":"D","x":19,"y":5,"s":1,"i":0},{
"key":"B","x":19,"y":7,"s":1,"i":0},{
"key":"E","x":19,"y":9,"s":1,"i":0},{
"key":"E","x":20,"y":0,"s":1,"i":0},{
"key":"B","x":20,"y":2,"s":1,"i":0},{
"key":"E","x":20,"y":4,"s":1,"i":0},{
"key":"H","x":20,"y":5,"s":1,"i":0},{
"key":"A","x":20,"y":6,"s":1,"i":0},{
"key":"D","x":20,"y":8,"s":1,"i":0},{
"key":"A","x":20,"y":10,"s":1,"i":0},{
"key":"D","x":21,"y":0,"s":1,"i":0},{
"key":"C","x":21,"y":2,"s":1,"i":0},{
"key":"B","x":21,"y":4,"s":1,"i":0},{
"key":"A","x":21,"y":5,"s":1,"i":0},{
"key":"D","x":21,"y":7,"s":1,"i":0},{
"key":"B","x":21,"y":9,"s":1,"i":0},{
"key":"B","x":22,"y":0,"s":1,"i":0},{
"key":"C","x":22,"y":2,"s":1,"i":0},{
"key":"B","x":22,"y":4,"s":1,"i":0},{
"key":"H","x":22,"y":5,"s":1,"i":0},{
"key":"E","x":22,"y":6,"s":1,"i":0},{
"key":"C","x":22,"y":8,"s":1,"i":0},{
"key":"B","x":22,"y":10,"s":1,"i":0},{
"key":"A","x":23,"y":0,"s":1,"i":0},{
"key":"A","x":23,"y":2,"s":1,"i":0},{
"key":"C","x":23,"y":4,"s":1,"i":0},{
"key":"D","x":23,"y":5,"s":1,"i":0},{
"key":"E","x":23,"y":7,"s":1,"i":0},{
"key":"A","x":23,"y":9,"s":1,"i":0},{
"key":"E","x":24,"y":0,"s":1,"i":0},{
"key":"D","x":24,"y":2,"s":1,"i":0},{
"key":"E","x":24,"y":4,"s":1,"i":0},{
"key":"H","x":24,"y":5,"s":1,"i":0},{
"key":"B","x":24,"y":6,"s":1,"i":0},{
"key":"C","x":24,"y":8,"s":1,"i":0},{
"key":"C","x":24,"y":10,"s":1,"i":0},{
"key":"D","x":25,"y":0,"s":1,"i":0},{
"key":"E","x":25,"y":2,"s":1,"i":0},{
"key":"A","x":25,"y":4,"s":1,"i":0},{
"key":"B","x":25,"y":5,"s":1,"i":0},{
"key":"A","x":25,"y":7,"s":1,"i":0},{
"key":"A","x":25,"y":9,"s":1,"i":0}],"sub
":[{
"key":"S","x":11,"y":0,"s":0,"i":0},{
"key":"S","x":11,"y":2,"s":0,"i":0},{
"key":"S","x":11,"y":4,"s":0,"i":0},{
"key":"S","x":11,"y":5,"s":0,"i":0},{
"key":"S","x":11,"y":7,"s":0,"i":0},{
"key":"S","x":11,"y":9,"s":0,"i":0},{
"key":"S","x":13,"y":0,"s":0,"i":0},{
"key":"S","x":13,"y":2,"s":0,"i":0},{
"key":"S","x":13,"y":4,"s":0,"i":0},{
"key":"S","x":13,"y":5,"s":0,"i":0},{
"key":"S","x":13,"y":7,"s":0,"i":0},{
"key":"S","x":13,"y":9,"s":0,"i":0},{
"key":"S","x":15,"y":0,"s":0,"i":0},{
"key":"S","x":15,"y":2,"s":0,"i":0},{
"key":"S","x":15,"y":4,"s":0,"i":0},{
"key":"S","x":15,"y":5,"s":0,"i":0},{
"key":"S","x":15,"y":7,"s":0,"i":0},{
"key":"S","x":15,"y":9,"s":0,"i":0},{
"key":"S","x":17,"y":0,"s":0,"i":0},{
"key":"S","x":17,"y":4,"s":0,"i":0},{
"key":"S","x":17,"y":5,"s":0,"i":0},{
"key":"S","x":17,"y":9,"s":0,"i":0},{
"key":"S","x":18,"y":0,"s":0,"i":0},{
"key":"S","x":18,"y":2,"s":0,"i":0},{
"key":"S","x":18,"y":4,"s":0,"i":0},{
"key":"S","x":18,"y":6,"s":0,"i":0},{
"key":"S","x":18,"y":8,"s":0,"i":0},{
"key":"S","x":18,"y":10,"s":0,"i":0},{
"key":"S","x":19,"y":0,"s":0,"i":0},{
"key":"S","x":19,"y":4,"s":0,"i":0},{
"key":"S","x":19,"y":5,"s":0,"i":0},{
"key":"S","x":19,"y":9,"s":0,"i":0},{
"key":"S","x":21,"y":0,"s":0,"i":0},{
"key":"S","x":21,"y":2,"s":0,"i":0},{
"key":"S","x":21,"y":4,"s":0,"i":0},{
"key":"S","x":21,"y":5,"s":0,"i":0},{
"key":"S","x":21,"y":7,"s":0,"i":0},{
"key":"S","x":21,"y":9,"s":0,"i":0},{
"key":"S","x":23,"y":0,"s":0,"i":0},{
"key":"S","x":23,"y":2,"s":0,"i":0},{
"key":"S","x":23,"y":4,"s":0,"i":0},{
"key":"S","x":23,"y":5,"s":0,"i":0},{
"key":"S","x":23,"y":7,"s":0,"i":0},{
"key":"S","x":23,"y":9,"s":0,"i":0}],"down
":[],"jysub

":[]}