{
"BackCround":{
"backCround_type":1,"bottom_type":2,"skill_type":0},"level":510,"mode":1,"LevelType":{
"Key":"@","Type":1,"Number":4},"Star":{
"star1":120,"star2":30000,"star3":32000},"Gang":{
"Gang1":1,"Gang2":1,"Gang3":1,"Gang4":1,"Gang5":0},"ReadyBubble":{
"R1":0,"R2":0,"R3":0,"R4":0},"BallNumber":31,"TimeLimit":0,"ObjChance":[{
"Key":"C","P":4},{
"Key":"A","P":4},{
"Key":"B","P":4},{
"Key":"E","P":4},{
"Key":"D","P":4}],"top":[],"bubble
":[{
"key":"C1","x":0,"y":2,"s":1,"i":0},{
"key":"C1","x":0,"y":3,"s":1,"i":0},{
"key":"C1","x":0,"y":4,"s":1,"i":0},{
"key":"BJ","x":0,"y":5,"s":1,"i":0},{
"key":"C1","x":0,"y":6,"s":1,"i":0},{
"key":"C1","x":0,"y":7,"s":1,"i":0},{
"key":"C1","x":0,"y":8,"s":1,"i":0},{
"key":"C1","x":1,"y":2,"s":1,"i":0},{
"key":"AJ","x":1,"y":3,"s":1,"i":0},{
"key":"C1","x":1,"y":4,"s":1,"i":0},{
"key":"C1","x":1,"y":5,"s":1,"i":0},{
"key":"EJ","x":1,"y":6,"s":1,"i":0},{
"key":"C1","x":1,"y":7,"s":1,"i":0},{
"key":"C1","x":2,"y":3,"s":1,"i":0},{
"key":"C1","x":2,"y":4,"s":1,"i":0},{
"key":"DJ","x":2,"y":5,"s":1,"i":0},{
"key":"C1","x":2,"y":6,"s":1,"i":0},{
"key":"C1","x":2,"y":7,"s":1,"i":0},{
"key":"H","x":3,"y":2,"s":1,"i":0},{
"key":"C1","x":3,"y":3,"s":1,"i":0},{
"key":"C1","x":3,"y":4,"s":1,"i":0},{
"key":"C1","x":3,"y":5,"s":1,"i":0},{
"key":"C1","x":3,"y":6,"s":1,"i":0},{
"key":"H","x":3,"y":7,"s":1,"i":0},{
"key":"H","x":4,"y":2,"s":1,"i":0},{
"key":"I","x":4,"y":4,"s":1,"i":0},{
"key":"C1","x":4,"y":5,"s":1,"i":0},{
"key":"I","x":4,"y":6,"s":1,"i":0},{
"key":"H","x":4,"y":8,"s":1,"i":0},{
"key":"H","x":5,"y":1,"s":1,"i":0},{
"key":"C1","x":5,"y":4,"s":1,"i":0},{
"key":"C1","x":5,"y":5,"s":1,"i":0},{
"key":"H","x":5,"y":8,"s":1,"i":0},{
"key":"H","x":6,"y":1,"s":1,"i":0},{
"key":"I","x":6,"y":5,"s":1,"i":0},{
"key":"H","x":6,"y":9,"s":1,"i":0},{
"key":"H","x":7,"y":0,"s":1,"i":0},{
"key":"N","x":7,"y":1,"s":1,"i":0},{
"key":"H","x":7,"y":2,"s":1,"i":0},{
"key":"H","x":7,"y":3,"s":1,"i":0},{
"key":"H","x":7,"y":4,"s":1,"i":0},{
"key":"H","x":7,"y":5,"s":1,"i":0},{
"key":"H","x":7,"y":6,"s":1,"i":0},{
"key":"H","x":7,"y":7,"s":1,"i":0},{
"key":"N","x":7,"y":8,"s":1,"i":0},{
"key":"H","x":7,"y":9,"s":1,"i":0},{
"key":"H","x":8,"y":1,"s":1,"i":0},{
"key":"H","x":8,"y":9,"s":1,"i":0},{
"key":"H","x":9,"y":1,"s":1,"i":0},{
"key":"H","x":9,"y":8,"s":1,"i":0},{
"key":"H","x":10,"y":2,"s":1,"i":0},{
"key":"H","x":10,"y":8,"s":1,"i":0},{
"key":"A","x":11,"y":2,"s":1,"i":0},{
"key":"C","x":11,"y":7,"s":1,"i":0},{
"key":"F","x":12,"y":2,"s":1,"i":0},{
"key":"A","x":12,"y":3,"s":1,"i":0},{
"key":"C","x":12,"y":7,"s":1,"i":0},{
"key":"F","x":12,"y":8,"s":1,"i":0},{
"key":"F","x":13,"y":1,"s":1,"i":0},{
"key":"J","x":13,"y":2,"s":1,"i":0},{
"key":"D","x":13,"y":3,"s":1,"i":0},{
"key":"B","x":13,"y":6,"s":1,"i":0},{
"key":"J","x":13,"y":7,"s":1,"i":0},{
"key":"F","x":13,"y":8,"s":1,"i":0},{
"key":"F","x":14,"y":1,"s":1,"i":0},{
"key":"B","x":14,"y":2,"s":1,"i":0},{
"key":"D","x":14,"y":3,"s":1,"i":0},{
"key":"D","x":14,"y":4,"s":1,"i":0},{
"key":"B","x":14,"y":6,"s":1,"i":0},{
"key":"B","x":14,"y":7,"s":1,"i":0},{
"key":"D","x":14,"y":8,"s":1,"i":0},{
"key":"F","x":14,"y":9,"s":1,"i":0},{
"key":"F","x":15,"y":0,"s":1,"i":0},{
"key":"B","x":15,"y":1,"s":1,"i":0},{
"key":"E","x":15,"y":2,"s":1,"i":0},{
"key":"E","x":15,"y":3,"s":1,"i":0},{
"key":"@","x":15,"y":4,"s":1,"i":0},{
"key":"@","x":15,"y":5,"s":1,"i":0},{
"key":"A","x":15,"y":6,"s":1,"i":0},{
"key":"A","x":15,"y":7,"s":1,"i":0},{
"key":"D","x":15,"y":8,"s":1,"i":0},{
"key":"F","x":15,"y":9,"s":1,"i":0},{
"key":"B","x":16,"y":1,"s":1,"i":0},{
"key":"A","x":16,"y":2,"s":1,"i":0},{
"key":"C","x":16,"y":3,"s":1,"i":0},{
"key":"E","x":16,"y":4,"s":1,"i":0},{
"key":"A","x":16,"y":6,"s":1,"i":0},{
"key":"C","x":16,"y":7,"s":1,"i":0},{
"key":"E","x":16,"y":8,"s":1,"i":0},{
"key":"E","x":16,"y":9,"s":1,"i":0},{
"key":"A","x":17,"y":1,"s":1,"i":0},{
"key":"D","x":17,"y":2,"s":1,"i":0},{
"key":"C","x":17,"y":3,"s":1,"i":0},{
"key":"C","x":17,"y":6,"s":1,"i":0},{
"key":"B","x":17,"y":7,"s":1,"i":0},{
"key":"E","x":17,"y":8,"s":1,"i":0},{
"key":"A","x":18,"y":2,"s":1,"i":0},{
"key":"D","x":18,"y":3,"s":1,"i":0},{
"key":"C","x":18,"y":7,"s":1,"i":0},{
"key":"B","x":18,"y":8,"s":1,"i":0},{
"key":"D","x":19,"y":2,"s":1,"i":0},{
"key":"B","x":19,"y":7,"s":1,"i":0},{
"key":"I","x":20,"y":2,"s":1,"i":0},{
"key":"I","x":20,"y":3,"s":1,"i":0},{
"key":"I","x":20,"y":4,"s":1,"i":0},{
"key":"I","x":20,"y":5,"s":1,"i":0},{
"key":"I","x":20,"y":6,"s":1,"i":0},{
"key":"I","x":20,"y":7,"s":1,"i":0},{
"key":"I","x":20,"y":8,"s":1,"i":0},{
"key":"I","x":21,"y":1,"s":1,"i":0},{
"key":"I","x":21,"y":8,"s":1,"i":0},{
"key":"I","x":22,"y":1,"s":1,"i":0},{
"key":"L","x":22,"y":2,"s":1,"i":0},{
"key":"L","x":22,"y":8,"s":1,"i":0},{
"key":"I","x":22,"y":9,"s":1,"i":0},{
"key":"I","x":23,"y":1,"s":1,"i":0},{
"key":"I","x":23,"y":7,"s":1,"i":0},{
"key":"I","x":23,"y":8,"s":1,"i":0},{
"key":"I","x":24,"y":2,"s":1,"i":0},{
"key":"I","x":24,"y":3,"s":1,"i":0},{
"key":"G","x":24,"y":7,"s":1,"i":0},{
"key":"G","x":24,"y":8,"s":1,"i":0},{
"key":"C","x":25,"y":2,"s":1,"i":0},{
"key":"C","x":25,"y":3,"s":1,"i":0},{
"key":"E","x":25,"y":4,"s":1,"i":0},{
"key":"E","x":25,"y":5,"s":1,"i":0},{
"key":"B","x":25,"y":6,"s":1,"i":0},{
"key":"B","x":25,"y":7,"s":1,"i":0},{
"key":"C","x":26,"y":2,"s":1,"i":0},{
"key":"C","x":26,"y":3,"s":1,"i":0},{
"key":"D","x":26,"y":4,"s":1,"i":0},{
"key":"E","x":26,"y":5,"s":1,"i":0},{
"key":"C","x":26,"y":6,"s":1,"i":0},{
"key":"B","x":26,"y":7,"s":1,"i":0},{
"key":"B","x":26,"y":8,"s":1,"i":0},{
"key":"D","x":27,"y":1,"s":1,"i":0},{
"key":"D","x":27,"y":2,"s":1,"i":0},{
"key":"B","x":27,"y":3,"s":1,"i":0},{
"key":"D","x":27,"y":4,"s":1,"i":0},{
"key":"A","x":27,"y":5,"s":1,"i":0},{
"key":"A","x":27,"y":6,"s":1,"i":0},{
"key":"E","x":27,"y":7,"s":1,"i":0},{
"key":"D","x":27,"y":8,"s":1,"i":0},{
"key":"D","x":28,"y":1,"s":1,"i":0},{
"key":"B","x":28,"y":2,"s":1,"i":0},{
"key":"B","x":28,"y":3,"s":1,"i":0},{
"key":"D","x":28,"y":4,"s":1,"i":0},{
"key":"E","x":28,"y":5,"s":1,"i":0},{
"key":"B","x":28,"y":6,"s":1,"i":0},{
"key":"A","x":28,"y":7,"s":1,"i":0},{
"key":"E","x":28,"y":8,"s":1,"i":0},{
"key":"E","x":28,"y":9,"s":1,"i":0},{
"key":"A","x":29,"y":1,"s":1,"i":0},{
"key":"A","x":29,"y":2,"s":1,"i":0},{
"key":"C","x":29,"y":3,"s":1,"i":0},{
"key":"E","x":29,"y":4,"s":1,"i":0},{
"key":"E","x":29,"y":5,"s":1,"i":0},{
"key":"B","x":29,"y":6,"s":1,"i":0},{
"key":"C","x":29,"y":7,"s":1,"i":0},{
"key":"C","x":29,"y":8,"s":1,"i":0},{
"key":"B","x":30,"y":2,"s":1,"i":0},{
"key":"A","x":30,"y":3,"s":1,"i":0},{
"key":"C","x":30,"y":4,"s":1,"i":0},{
"key":"B","x":30,"y":6,"s":1,"i":0},{
"key":"C","x":30,"y":7,"s":1,"i":0},{
"key":"D","x":30,"y":8,"s":1,"i":0},{
"key":"B","x":31,"y":2,"s":1,"i":0},{
"key":"C","x":31,"y":3,"s":1,"i":0},{
"key":"D","x":31,"y":6,"s":1,"i":0},{
"key":"D","x":31,"y":7,"s":1,"i":0},{
"key":"B","x":32,"y":3,"s":1,"i":0},{
"key":"D","x":32,"y":7,"s":1,"i":0}],"sub
":[{
"key":"S","x":11,"y":2,"s":0,"i":0},{
"key":"S","x":11,"y":7,"s":0,"i":0},{
"key":"S","x":12,"y":3,"s":0,"i":0},{
"key":"S","x":12,"y":7,"s":0,"i":0},{
"key":"S","x":13,"y":3,"s":0,"i":0},{
"key":"S","x":13,"y":6,"s":0,"i":0},{
"key":"S","x":14,"y":2,"s":0,"i":0},{
"key":"S","x":14,"y":4,"s":0,"i":0},{
"key":"S","x":14,"y":6,"s":0,"i":0},{
"key":"S","x":14,"y":8,"s":0,"i":0},{
"key":"S","x":15,"y":2,"s":0,"i":0},{
"key":"S","x":15,"y":4,"s":0,"i":0},{
"key":"S","x":15,"y":5,"s":0,"i":0},{
"key":"S","x":15,"y":7,"s":0,"i":0},{
"key":"S","x":16,"y":1,"s":0,"i":0},{
"key":"S","x":16,"y":3,"s":0,"i":0},{
"key":"S","x":16,"y":4,"s":0,"i":0},{
"key":"S","x":16,"y":6,"s":0,"i":0},{
"key":"S","x":16,"y":7,"s":0,"i":0},{
"key":"S","x":16,"y":9,"s":0,"i":0},{
"key":"S","x":17,"y":1,"s":0,"i":0},{
"key":"S","x":17,"y":3,"s":0,"i":0},{
"key":"S","x":17,"y":6,"s":0,"i":0},{
"key":"S","x":17,"y":8,"s":0,"i":0},{
"key":"S","x":18,"y":2,"s":0,"i":0},{
"key":"S","x":18,"y":3,"s":0,"i":0},{
"key":"S","x":18,"y":7,"s":0,"i":0},{
"key":"S","x":18,"y":8,"s":0,"i":0},{
"key":"S","x":19,"y":2,"s":0,"i":0},{
"key":"S","x":19,"y":7,"s":0,"i":0},{
"key":"S","x":25,"y":2,"s":0,"i":0},{
"key":"S","x":25,"y":3,"s":0,"i":0},{
"key":"S","x":25,"y":4,"s":0,"i":0},{
"key":"S","x":25,"y":5,"s":0,"i":0},{
"key":"S","x":25,"y":6,"s":0,"i":0},{
"key":"S","x":25,"y":7,"s":0,"i":0},{
"key":"S","x":26,"y":2,"s":0,"i":0},{
"key":"S","x":26,"y":8,"s":0,"i":0},{
"key":"S","x":27,"y":1,"s":0,"i":0},{
"key":"S","x":27,"y":2,"s":0,"i":0},{
"key":"S","x":27,"y":3,"s":0,"i":0},{
"key":"S","x":27,"y":4,"s":0,"i":0},{
"key":"S","x":27,"y":5,"s":0,"i":0},{
"key":"S","x":27,"y":6,"s":0,"i":0},{
"key":"S","x":27,"y":7,"s":0,"i":0},{
"key":"S","x":27,"y":8,"s":0,"i":0},{
"key":"S","x":28,"y":1,"s":0,"i":0},{
"key":"S","x":28,"y":5,"s":0,"i":0},{
"key":"S","x":28,"y":9,"s":0,"i":0},{
"key":"S","x":29,"y":1,"s":0,"i":0},{
"key":"S","x":29,"y":2,"s":0,"i":0},{
"key":"S","x":29,"y":3,"s":0,"i":0},{
"key":"S","x":29,"y":4,"s":0,"i":0},{
"key":"S","x":29,"y":5,"s":0,"i":0},{
"key":"S","x":29,"y":6,"s":0,"i":0},{
"key":"S","x":29,"y":7,"s":0,"i":0},{
"key":"S","x":29,"y":8,"s":0,"i":0},{
"key":"S","x":30,"y":2,"s":0,"i":0},{
"key":"S","x":30,"y":4,"s":0,"i":0},{
"key":"S","x":30,"y":6,"s":0,"i":0},{
"key":"S","x":30,"y":8,"s":0,"i":0},{
"key":"S","x":31,"y":2,"s":0,"i":0},{
"key":"S","x":31,"y":3,"s":0,"i":0},{
"key":"S","x":31,"y":6,"s":0,"i":0},{
"key":"S","x":31,"y":7,"s":0,"i":0},{
"key":"S","x":32,"y":3,"s":0,"i":0},{
"key":"S","x":32,"y":7,"s":0,"i":0}]}