{
"BackCround":{
"backCround_type":1,"bottom_type":2,"skill_type":0},"level":365,"mode":1,"LevelType":{
"Key":"@","Type":1,"Number":5},"Star":{
"star1":120,"star2":20000,"star3":31000},"Gang":{
"Gang1":0,"Gang2":0,"Gang3":1,"Gang4":1,"Gang5":0},"ReadyBubble":{
"R1":0,"R2":0,"R3":0,"R4":0},"BallNumber":30,"TimeLimit":0,"ObjChance":[{
"Key":"C","P":5},{
"Key":"A","P":5},{
"Key":"B","P":5},{
"Key":"E","P":5},{
"Key":"D","P":5}],"top":[],"bubble
":[{
"key":"@","x":0,"y":0,"s":1,"i":0},{
"key":"@","x":0,"y":1,"s":1,"i":0},{
"key":"@","x":0,"y":2,"s":1,"i":0},{
"key":"@","x":0,"y":3,"s":1,"i":0},{
"key":"@","x":0,"y":4,"s":1,"i":0},{
"key":"@","x":0,"y":5,"s":1,"i":0},{
"key":"AJ","x":0,"y":6,"s":1,"i":0},{
"key":"@","x":0,"y":7,"s":1,"i":0},{
"key":"@","x":0,"y":8,"s":1,"i":0},{
"key":"BJ","x":0,"y":9,"s":1,"i":0},{
"key":"@","x":0,"y":10,"s":1,"i":0},{
"key":"CJ","x":1,"y":2,"s":1,"i":0},{
"key":"D1","x":1,"y":4,"s":1,"i":0},{
"key":"D1","x":1,"y":5,"s":1,"i":0},{
"key":"D1","x":1,"y":6,"s":1,"i":0},{
"key":"D1","x":1,"y":7,"s":1,"i":0},{
"key":"D1","x":2,"y":2,"s":1,"i":0},{
"key":"D1","x":2,"y":3,"s":1,"i":0},{
"key":"D1","x":2,"y":5,"s":1,"i":0},{
"key":"D1","x":2,"y":7,"s":1,"i":0},{
"key":"D1","x":3,"y":1,"s":1,"i":0},{
"key":"D1","x":3,"y":3,"s":1,"i":0},{
"key":"D1","x":3,"y":5,"s":1,"i":0},{
"key":"D1","x":3,"y":6,"s":1,"i":0},{
"key":"D1","x":3,"y":8,"s":1,"i":0},{
"key":"D1","x":4,"y":1,"s":1,"i":0},{
"key":"D1","x":4,"y":2,"s":1,"i":0},{
"key":"D1","x":4,"y":3,"s":1,"i":0},{
"key":"D1","x":4,"y":4,"s":1,"i":0},{
"key":"D1","x":4,"y":6,"s":1,"i":0},{
"key":"D1","x":4,"y":8,"s":1,"i":0},{
"key":"D1","x":4,"y":9,"s":1,"i":0},{
"key":"D1","x":5,"y":4,"s":1,"i":0},{
"key":"D1","x":5,"y":5,"s":1,"i":0},{
"key":"D1","x":5,"y":7,"s":1,"i":0},{
"key":"D1","x":5,"y":9,"s":1,"i":0},{
"key":"C1","x":6,"y":0,"s":1,"i":0},{
"key":"C1","x":6,"y":1,"s":1,"i":0},{
"key":"H","x":6,"y":2,"s":1,"i":0},{
"key":"D1","x":6,"y":3,"s":1,"i":0},{
"key":"D1","x":6,"y":4,"s":1,"i":0},{
"key":"H","x":6,"y":5,"s":1,"i":0},{
"key":"D1","x":6,"y":6,"s":1,"i":0},{
"key":"D1","x":6,"y":7,"s":1,"i":0},{
"key":"H","x":6,"y":8,"s":1,"i":0},{
"key":"D1","x":6,"y":9,"s":1,"i":0},{
"key":"D1","x":6,"y":10,"s":1,"i":0},{
"key":"D1","x":7,"y":0,"s":1,"i":0},{
"key":"D1","x":7,"y":2,"s":1,"i":0},{
"key":"D1","x":7,"y":4,"s":1,"i":0},{
"key":"D1","x":7,"y":5,"s":1,"i":0},{
"key":"D1","x":8,"y":1,"s":1,"i":0},{
"key":"D1","x":8,"y":2,"s":1,"i":0},{
"key":"D1","x":8,"y":4,"s":1,"i":0},{
"key":"D1","x":8,"y":6,"s":1,"i":0},{
"key":"D1","x":8,"y":7,"s":1,"i":0},{
"key":"D1","x":8,"y":8,"s":1,"i":0},{
"key":"D1","x":8,"y":9,"s":1,"i":0},{
"key":"D1","x":9,"y":1,"s":1,"i":0},{
"key":"D1","x":9,"y":3,"s":1,"i":0},{
"key":"D1","x":9,"y":4,"s":1,"i":0},{
"key":"D1","x":9,"y":6,"s":1,"i":0},{
"key":"D1","x":9,"y":8,"s":1,"i":0},{
"key":"D1","x":10,"y":3,"s":1,"i":0},{
"key":"D1","x":10,"y":5,"s":1,"i":0},{
"key":"D1","x":10,"y":7,"s":1,"i":0},{
"key":"D1","x":10,"y":8,"s":1,"i":0},{
"key":"D1","x":11,"y":2,"s":1,"i":0},{
"key":"D1","x":11,"y":3,"s":1,"i":0},{
"key":"D1","x":11,"y":4,"s":1,"i":0},{
"key":"D1","x":11,"y":5,"s":1,"i":0},{
"key":"D1","x":11,"y":7,"s":1,"i":0},{
"key":"@","x":13,"y":2,"s":1,"i":0},{
"key":"A","x":13,"y":4,"s":1,"i":0},{
"key":"A","x":13,"y":5,"s":1,"i":0},{
"key":"C","x":13,"y":7,"s":1,"i":0},{
"key":"J","x":14,"y":3,"s":1,"i":0},{
"key":"@","x":14,"y":4,"s":1,"i":0},{
"key":"BJ","x":14,"y":6,"s":1,"i":0},{
"key":"C","x":14,"y":7,"s":1,"i":0},{
"key":"@","x":15,"y":1,"s":1,"i":0},{
"key":"EJ","x":15,"y":2,"s":1,"i":0},{
"key":"E","x":15,"y":3,"s":1,"i":0},{
"key":"B","x":15,"y":6,"s":1,"i":0},{
"key":"D","x":15,"y":7,"s":1,"i":0},{
"key":"D","x":15,"y":8,"s":1,"i":0},{
"key":"A","x":16,"y":1,"s":1,"i":0},{
"key":"E","x":16,"y":4,"s":1,"i":0},{
"key":"B","x":16,"y":6,"s":1,"i":0},{
"key":"J","x":16,"y":9,"s":1,"i":0},{
"key":"A","x":17,"y":1,"s":1,"i":0},{
"key":"D1","x":17,"y":4,"s":1,"i":0},{
"key":"D1","x":17,"y":5,"s":1,"i":0},{
"key":"C","x":17,"y":8,"s":1,"i":0},{
"key":"A","x":18,"y":0,"s":1,"i":0},{
"key":"A","x":18,"y":1,"s":1,"i":0},{
"key":"D","x":18,"y":2,"s":1,"i":0},{
"key":"D","x":18,"y":3,"s":1,"i":0},{
"key":"D1","x":18,"y":4,"s":1,"i":0},{
"key":"H","x":18,"y":5,"s":1,"i":0},{
"key":"D1","x":18,"y":6,"s":1,"i":0},{
"key":"C","x":18,"y":7,"s":1,"i":0},{
"key":"C","x":18,"y":8,"s":1,"i":0},{
"key":"@","x":18,"y":9,"s":1,"i":0},{
"key":"@","x":18,"y":10,"s":1,"i":0},{
"key":"D","x":19,"y":1,"s":1,"i":0},{
"key":"D1","x":19,"y":4,"s":1,"i":0},{
"key":"D1","x":19,"y":5,"s":1,"i":0},{
"key":"@","x":19,"y":8,"s":1,"i":0},{
"key":"@","x":20,"y":1,"s":1,"i":0},{
"key":"B","x":20,"y":4,"s":1,"i":0},{
"key":"A","x":20,"y":6,"s":1,"i":0},{
"key":"@","x":20,"y":9,"s":1,"i":0},{
"key":"E","x":21,"y":1,"s":1,"i":0},{
"key":"E","x":21,"y":2,"s":1,"i":0},{
"key":"B","x":21,"y":3,"s":1,"i":0},{
"key":"A","x":21,"y":6,"s":1,"i":0},{
"key":"A","x":21,"y":7,"s":1,"i":0},{
"key":"D","x":21,"y":8,"s":1,"i":0},{
"key":"E","x":22,"y":3,"s":1,"i":0},{
"key":"B","x":22,"y":4,"s":1,"i":0},{
"key":"C","x":22,"y":6,"s":1,"i":0},{
"key":"@","x":22,"y":7,"s":1,"i":0},{
"key":"@","x":23,"y":2,"s":1,"i":0},{
"key":"@","x":23,"y":4,"s":1,"i":0},{
"key":"C","x":23,"y":5,"s":1,"i":0},{
"key":"D","x":23,"y":7,"s":1,"i":0}],"sub
":[]}