{
"BackCround":{
"backCround_type":1,"bottom_type":2,"skill_type":0},"level":212,"mode":1,"LevelType":{
"Key":"@","Type":1,"Number":3},"Star":{
"star1":120,"star2":20000,"star3":40000},"Gang":{
"Gang1":0,"Gang2":0,"Gang3":0,"Gang4":0,"Gang5":1},"ReadyBubble":{
"R1":0,"R2":0,"R3":0,"R4":0},"BallNumber":32,"TimeLimit":0,"ObjChance":[{
"Key":"C","P":5},{
"Key":"A","P":5},{
"Key":"B","P":5},{
"Key":"E","P":5},{
"Key":"D","P":5}],"top":[],"bubble
":[{
"key":"D","x":0,"y":3,"s":1,"i":0},{
"key":"E","x":0,"y":4,"s":1,"i":0},{
"key":"E1","x":0,"y":5,"s":1,"i":0},{
"key":"A1","x":0,"y":6,"s":1,"i":0},{
"key":"B1","x":0,"y":7,"s":1,"i":0},{
"key":"A","x":1,"y":2,"s":1,"i":0},{
"key":"C1","x":1,"y":3,"s":1,"i":0},{
"key":"C1","x":1,"y":4,"s":1,"i":0},{
"key":"A1","x":1,"y":5,"s":1,"i":0},{
"key":"B1","x":1,"y":6,"s":1,"i":0},{
"key":"A","x":1,"y":7,"s":1,"i":0},{
"key":"A","x":2,"y":2,"s":1,"i":0},{
"key":"E","x":2,"y":3,"s":1,"i":0},{
"key":"H","x":2,"y":4,"s":1,"i":0},{
"key":"H","x":2,"y":5,"s":1,"i":0},{
"key":"H","x":2,"y":6,"s":1,"i":0},{
"key":"C","x":2,"y":7,"s":1,"i":0},{
"key":"B","x":2,"y":8,"s":1,"i":0},{
"key":"C1","x":3,"y":1,"s":1,"i":0},{
"key":"E","x":3,"y":2,"s":1,"i":0},{
"key":"H","x":3,"y":3,"s":1,"i":0},{
"key":"BJ","x":3,"y":4,"s":1,"i":0},{
"key":"AJ","x":3,"y":5,"s":1,"i":0},{
"key":"H","x":3,"y":6,"s":1,"i":0},{
"key":"C","x":3,"y":7,"s":1,"i":0},{
"key":"B","x":3,"y":8,"s":1,"i":0},{
"key":"C","x":4,"y":1,"s":1,"i":0},{
"key":"A","x":4,"y":2,"s":1,"i":0},{
"key":"H","x":4,"y":3,"s":1,"i":0},{
"key":"CJ","x":4,"y":5,"s":1,"i":0},{
"key":"H","x":4,"y":7,"s":1,"i":0},{
"key":"D","x":4,"y":8,"s":1,"i":0},{
"key":"D","x":4,"y":9,"s":1,"i":0},{
"key":"A","x":5,"y":0,"s":1,"i":0},{
"key":"B","x":5,"y":1,"s":1,"i":0},{
"key":"H","x":5,"y":2,"s":1,"i":0},{
"key":"H","x":5,"y":7,"s":1,"i":0},{
"key":"B","x":5,"y":8,"s":1,"i":0},{
"key":"A","x":5,"y":9,"s":1,"i":0},{
"key":"A","x":6,"y":1,"s":1,"i":0},{
"key":"B","x":6,"y":2,"s":1,"i":0},{
"key":"H","x":6,"y":3,"s":1,"i":0},{
"key":"H","x":6,"y":7,"s":1,"i":0},{
"key":"C","x":6,"y":8,"s":1,"i":0},{
"key":"B","x":6,"y":9,"s":1,"i":0},{
"key":"I","x":7,"y":1,"s":1,"i":0},{
"key":"D","x":7,"y":2,"s":1,"i":0},{
"key":"H","x":7,"y":3,"s":1,"i":0},{
"key":"H","x":7,"y":6,"s":1,"i":0},{
"key":"C","x":7,"y":7,"s":1,"i":0},{
"key":"I","x":7,"y":8,"s":1,"i":0},{
"key":"D","x":8,"y":2,"s":1,"i":0},{
"key":"E","x":8,"y":3,"s":1,"i":0},{
"key":"H","x":8,"y":4,"s":1,"i":0},{
"key":"H","x":8,"y":5,"s":1,"i":0},{
"key":"H","x":8,"y":6,"s":1,"i":0},{
"key":"E","x":8,"y":7,"s":1,"i":0},{
"key":"E","x":8,"y":8,"s":1,"i":0},{
"key":"B","x":9,"y":2,"s":1,"i":0},{
"key":"E","x":9,"y":3,"s":1,"i":0},{
"key":"E","x":9,"y":4,"s":1,"i":0},{
"key":"D","x":9,"y":5,"s":1,"i":0},{
"key":"D","x":9,"y":6,"s":1,"i":0},{
"key":"B","x":9,"y":7,"s":1,"i":0},{
"key":"A","x":10,"y":3,"s":1,"i":0},{
"key":"A","x":10,"y":4,"s":1,"i":0},{
"key":"C","x":10,"y":5,"s":1,"i":0},{
"key":"C","x":10,"y":6,"s":1,"i":0},{
"key":"B","x":10,"y":7,"s":1,"i":0},{
"key":"H","x":11,"y":4,"s":1,"i":0},{
"key":"H","x":11,"y":5,"s":1,"i":0},{
"key":"H","x":12,"y":4,"s":1,"i":0},{
"key":"H","x":12,"y":5,"s":1,"i":0},{
"key":"H","x":12,"y":6,"s":1,"i":0}],"sub
":[{
"key":"S","x":8,"y":2,"s":0,"i":0},{
"key":"S","x":8,"y":8,"s":0,"i":0},{
"key":"S","x":9,"y":2,"s":0,"i":0},{
"key":"S","x":9,"y":7,"s":0,"i":0},{
"key":"S","x":10,"y":4,"s":0,"i":0},{
"key":"S","x":10,"y":5,"s":0,"i":0},{
"key":"S","x":10,"y":6,"s":0,"i":0}],"down
":[],"jysub

":[]}