{
"BackCround":{
"backCround_type":1,"bottom_type":2,"skill_type":0},"level":362,"mode":1,"LevelType":{
"Key":"@","Type":1,"Number":4},"Star":{
"star1":120,"star2":20000,"star3":59000},"Gang":{
"Gang1":0,"Gang2":1,"Gang3":0,"Gang4":0,"Gang5":0},"ReadyBubble":{
"R1":0,"R2":0,"R3":0,"R4":0},"BallNumber":32,"TimeLimit":0,"ObjChance":[{
"Key":"C","P":5},{
"Key":"A","P":5},{
"Key":"B","P":5},{
"Key":"E","P":5},{
"Key":"D","P":5}],"top":[],"bubble
":[{
"key":"CJ","x":0,"y":0,"s":1,"i":0},{
"key":"CJ","x":0,"y":1,"s":1,"i":0},{
"key":"E","x":0,"y":2,"s":1,"i":0},{
"key":"E","x":0,"y":3,"s":1,"i":0},{
"key":"C1","x":0,"y":4,"s":1,"i":0},{
"key":"AJ","x":0,"y":5,"s":1,"i":0},{
"key":"C1","x":0,"y":6,"s":1,"i":0},{
"key":"C1","x":0,"y":7,"s":1,"i":0},{
"key":"BJ","x":0,"y":8,"s":1,"i":0},{
"key":"C1","x":0,"y":9,"s":1,"i":0},{
"key":"A","x":0,"y":10,"s":1,"i":0},{
"key":"B","x":1,"y":0,"s":1,"i":0},{
"key":"B","x":1,"y":1,"s":1,"i":0},{
"key":"C1","x":1,"y":2,"s":1,"i":0},{
"key":"C1","x":1,"y":4,"s":1,"i":0},{
"key":"C1","x":1,"y":5,"s":1,"i":0},{
"key":"C1","x":1,"y":7,"s":1,"i":0},{
"key":"C1","x":1,"y":8,"s":1,"i":0},{
"key":"A","x":1,"y":9,"s":1,"i":0},{
"key":"G","x":2,"y":0,"s":1,"i":0},{
"key":"G","x":2,"y":1,"s":1,"i":0},{
"key":"G","x":2,"y":2,"s":1,"i":0},{
"key":"K","x":2,"y":4,"s":1,"i":0},{
"key":"K","x":2,"y":5,"s":1,"i":0},{
"key":"K","x":2,"y":6,"s":1,"i":0},{
"key":"C1","x":2,"y":8,"s":1,"i":0},{
"key":"C1","x":2,"y":9,"s":1,"i":0},{
"key":"A","x":2,"y":10,"s":1,"i":0},{
"key":"C1","x":3,"y":0,"s":1,"i":0},{
"key":"K","x":3,"y":1,"s":1,"i":0},{
"key":"G","x":3,"y":3,"s":1,"i":0},{
"key":"G","x":3,"y":4,"s":1,"i":0},{
"key":"G","x":3,"y":5,"s":1,"i":0},{
"key":"G","x":3,"y":6,"s":1,"i":0},{
"key":"K","x":3,"y":8,"s":1,"i":0},{
"key":"A","x":3,"y":9,"s":1,"i":0},{
"key":"@","x":4,"y":0,"s":1,"i":0},{
"key":"C1","x":4,"y":1,"s":1,"i":0},{
"key":"C1","x":4,"y":3,"s":1,"i":0},{
"key":"F","x":4,"y":4,"s":1,"i":0},{
"key":"C1","x":4,"y":5,"s":1,"i":0},{
"key":"C1","x":4,"y":6,"s":1,"i":0},{
"key":"C1","x":4,"y":7,"s":1,"i":0},{
"key":"G","x":4,"y":9,"s":1,"i":0},{
"key":"G","x":4,"y":10,"s":1,"i":0},{
"key":"@","x":5,"y":0,"s":1,"i":0},{
"key":"C1","x":5,"y":2,"s":1,"i":0},{
"key":"C1","x":5,"y":3,"s":1,"i":0},{
"key":"F","x":5,"y":4,"s":1,"i":0},{
"key":"C1","x":5,"y":5,"s":1,"i":0},{
"key":"C1","x":5,"y":6,"s":1,"i":0},{
"key":"C1","x":5,"y":7,"s":1,"i":0},{
"key":"C1","x":5,"y":9,"s":1,"i":0},{
"key":"@","x":6,"y":0,"s":1,"i":0},{
"key":"@","x":6,"y":1,"s":1,"i":0},{
"key":"@","x":6,"y":3,"s":1,"i":0},{
"key":"C1","x":6,"y":4,"s":1,"i":0},{
"key":"F","x":6,"y":5,"s":1,"i":0},{
"key":"C1","x":6,"y":6,"s":1,"i":0},{
"key":"C1","x":6,"y":7,"s":1,"i":0},{
"key":"C1","x":6,"y":9,"s":1,"i":0},{
"key":"C1","x":6,"y":10,"s":1,"i":0},{
"key":"@","x":7,"y":0,"s":1,"i":0},{
"key":"@","x":7,"y":1,"s":1,"i":0},{
"key":"@","x":7,"y":3,"s":1,"i":0},{
"key":"C1","x":7,"y":4,"s":1,"i":0},{
"key":"F","x":7,"y":5,"s":1,"i":0},{
"key":"C1","x":7,"y":6,"s":1,"i":0},{
"key":"C","x":7,"y":8,"s":1,"i":0},{
"key":"C","x":7,"y":9,"s":1,"i":0},{
"key":"@","x":8,"y":0,"s":1,"i":0},{
"key":"@","x":8,"y":1,"s":1,"i":0},{
"key":"L","x":8,"y":2,"s":1,"i":0},{
"key":"@","x":8,"y":4,"s":1,"i":0},{
"key":"C1","x":8,"y":5,"s":1,"i":0},{
"key":"C1","x":8,"y":6,"s":1,"i":0},{
"key":"B","x":8,"y":8,"s":1,"i":0},{
"key":"B","x":8,"y":9,"s":1,"i":0},{
"key":"C","x":8,"y":10,"s":1,"i":0},{
"key":"@","x":9,"y":0,"s":1,"i":0},{
"key":"@","x":9,"y":1,"s":1,"i":0},{
"key":"@","x":9,"y":2,"s":1,"i":0},{
"key":"D","x":9,"y":4,"s":1,"i":0},{
"key":"D","x":9,"y":5,"s":1,"i":0},{
"key":"B","x":9,"y":7,"s":1,"i":0},{
"key":"@","x":9,"y":8,"s":1,"i":0},{
"key":"C","x":9,"y":9,"s":1,"i":0},{
"key":"@","x":10,"y":0,"s":1,"i":0},{
"key":"@","x":10,"y":1,"s":1,"i":0},{
"key":"@","x":10,"y":2,"s":1,"i":0},{
"key":"@","x":10,"y":3,"s":1,"i":0},{
"key":"K","x":10,"y":5,"s":1,"i":0},{
"key":"@","x":10,"y":7,"s":1,"i":0},{
"key":"B","x":10,"y":8,"s":1,"i":0},{
"key":"B","x":10,"y":9,"s":1,"i":0},{
"key":"@","x":10,"y":10,"s":1,"i":0},{
"key":"H","x":11,"y":2,"s":1,"i":0},{
"key":"G","x":11,"y":4,"s":1,"i":0},{
"key":"G","x":11,"y":5,"s":1,"i":0},{
"key":"H","x":11,"y":7,"s":1,"i":0},{
"key":"H","x":12,"y":0,"s":1,"i":0},{
"key":"G","x":12,"y":1,"s":1,"i":0},{
"key":"A","x":12,"y":2,"s":1,"i":0},{
"key":"D","x":12,"y":3,"s":1,"i":0},{
"key":"D","x":12,"y":4,"s":1,"i":0},{
"key":"B","x":12,"y":5,"s":1,"i":0},{
"key":"C","x":12,"y":6,"s":1,"i":0},{
"key":"L","x":12,"y":7,"s":1,"i":0},{
"key":"B","x":12,"y":8,"s":1,"i":0},{
"key":"G","x":12,"y":9,"s":1,"i":0},{
"key":"H","x":12,"y":10,"s":1,"i":0},{
"key":"H","x":13,"y":1,"s":1,"i":0},{
"key":"A","x":13,"y":2,"s":1,"i":0},{
"key":"D","x":13,"y":3,"s":1,"i":0},{
"key":"B","x":13,"y":4,"s":1,"i":0},{
"key":"C","x":13,"y":5,"s":1,"i":0},{
"key":"J","x":13,"y":6,"s":1,"i":0},{
"key":"B","x":13,"y":7,"s":1,"i":0},{
"key":"H","x":13,"y":8,"s":1,"i":0},{
"key":"A","x":14,"y":3,"s":1,"i":0},{
"key":"B","x":14,"y":4,"s":1,"i":0},{
"key":"@","x":14,"y":5,"s":1,"i":0},{
"key":"C","x":14,"y":6,"s":1,"i":0},{
"key":"B","x":14,"y":7,"s":1,"i":0},{
"key":"G","x":15,"y":3,"s":1,"i":0},{
"key":"G","x":15,"y":4,"s":1,"i":0},{
"key":"G","x":15,"y":5,"s":1,"i":0},{
"key":"G","x":15,"y":6,"s":1,"i":0},{
"key":"B","x":16,"y":3,"s":1,"i":0},{
"key":"@","x":16,"y":4,"s":1,"i":0},{
"key":"@","x":16,"y":5,"s":1,"i":0},{
"key":"@","x":16,"y":6,"s":1,"i":0},{
"key":"@","x":16,"y":7,"s":1,"i":0},{
"key":"C","x":17,"y":1,"s":1,"i":0},{
"key":"K","x":17,"y":2,"s":1,"i":0},{
"key":"B","x":17,"y":3,"s":1,"i":0},{
"key":"@","x":17,"y":4,"s":1,"i":0},{
"key":"@","x":17,"y":5,"s":1,"i":0},{
"key":"A","x":17,"y":6,"s":1,"i":0},{
"key":"@","x":17,"y":7,"s":1,"i":0},{
"key":"@","x":17,"y":8,"s":1,"i":0},{
"key":"B","x":18,"y":0,"s":1,"i":0},{
"key":"B","x":18,"y":1,"s":1,"i":0},{
"key":"C","x":18,"y":2,"s":1,"i":0},{
"key":"B","x":18,"y":3,"s":1,"i":0},{
"key":"@","x":18,"y":4,"s":1,"i":0},{
"key":"@","x":18,"y":5,"s":1,"i":0},{
"key":"@","x":18,"y":6,"s":1,"i":0},{
"key":"A","x":18,"y":7,"s":1,"i":0},{
"key":"A","x":18,"y":8,"s":1,"i":0},{
"key":"A","x":18,"y":9,"s":1,"i":0},{
"key":"@","x":18,"y":10,"s":1,"i":0},{
"key":"B","x":19,"y":1,"s":1,"i":0},{
"key":"C","x":19,"y":2,"s":1,"i":0},{
"key":"D","x":19,"y":3,"s":1,"i":0},{
"key":"D","x":19,"y":4,"s":1,"i":0},{
"key":"E","x":19,"y":5,"s":1,"i":0},{
"key":"E","x":19,"y":6,"s":1,"i":0},{
"key":"E","x":19,"y":7,"s":1,"i":0},{
"key":"@","x":19,"y":8,"s":1,"i":0},{
"key":"C","x":20,"y":3,"s":1,"i":0},{
"key":"K","x":20,"y":4,"s":1,"i":0},{
"key":"D","x":20,"y":5,"s":1,"i":0},{
"key":"K","x":20,"y":6,"s":1,"i":0},{
"key":"K","x":20,"y":7,"s":1,"i":0},{
"key":"G","x":21,"y":3,"s":1,"i":0},{
"key":"G","x":21,"y":4,"s":1,"i":0},{
"key":"G","x":21,"y":5,"s":1,"i":0},{
"key":"G","x":21,"y":6,"s":1,"i":0},{
"key":"@","x":22,"y":3,"s":1,"i":0},{
"key":"@","x":22,"y":4,"s":1,"i":0},{
"key":"@","x":22,"y":6,"s":1,"i":0},{
"key":"@","x":22,"y":7,"s":1,"i":0},{
"key":"C","x":23,"y":1,"s":1,"i":0},{
"key":"F","x":23,"y":2,"s":1,"i":0},{
"key":"F","x":23,"y":3,"s":1,"i":0},{
"key":"F","x":23,"y":4,"s":1,"i":0},{
"key":"F","x":23,"y":5,"s":1,"i":0},{
"key":"F","x":23,"y":6,"s":1,"i":0},{
"key":"F","x":23,"y":7,"s":1,"i":0},{
"key":"B","x":23,"y":8,"s":1,"i":0},{
"key":"@","x":24,"y":0,"s":1,"i":0},{
"key":"C","x":24,"y":1,"s":1,"i":0},{
"key":"C","x":24,"y":2,"s":1,"i":0},{
"key":"@","x":24,"y":3,"s":1,"i":0},{
"key":"A","x":24,"y":5,"s":1,"i":0},{
"key":"A","x":24,"y":7,"s":1,"i":0},{
"key":"B","x":24,"y":8,"s":1,"i":0},{
"key":"D1","x":24,"y":9,"s":1,"i":0},{
"key":"D1","x":24,"y":10,"s":1,"i":0}],"sub
":[{
"key":"S","x":12,"y":2,"s":0,"i":0},{
"key":"S","x":12,"y":5,"s":0,"i":0},{
"key":"S","x":12,"y":6,"s":0,"i":0},{
"key":"S","x":12,"y":8,"s":0,"i":0},{
"key":"S","x":13,"y":2,"s":0,"i":0},{
"key":"S","x":13,"y":4,"s":0,"i":0},{
"key":"S","x":13,"y":5,"s":0,"i":0},{
"key":"S","x":13,"y":7,"s":0,"i":0},{
"key":"S","x":14,"y":3,"s":0,"i":0},{
"key":"S","x":14,"y":4,"s":0,"i":0},{
"key":"S","x":14,"y":6,"s":0,"i":0},{
"key":"S","x":14,"y":7,"s":0,"i":0}],"down
":[],"jysub

":[]}