{
"BackCround":{
"backCround_type":1,"bottom_type":2,"skill_type":0},"level":24,"mode":1,"LevelType":{
"Key":"@","Type":1,"Number":7},"Star":{
"star1":1000,"star2":10000,"star3":20000},"Gang":{
"Gang1":0,"Gang2":0,"Gang3":0,"Gang4":0,"Gang5":1},"ReadyBubble":{
"R1":1,"R2":4,"R3":0,"R4":0},"BallNumber":35,"TimeLimit":0,"ObjChance":[{
"Key":"C","P":1},{
"Key":"A","P":2},{
"Key":"B","P":3}],"top":[],"bubble
":[{
"key":"F","x":0,"y":0,"s":1,"i":0},{
"key":"F","x":0,"y":2,"s":1,"i":0},{
"key":"B","x":0,"y":4,"s":1,"i":0},{
"key":"B","x":0,"y":6,"s":1,"i":0},{
"key":"F","x":0,"y":8,"s":1,"i":0},{
"key":"F","x":0,"y":10,"s":1,"i":0},{
"key":"B","x":1,"y":0,"s":1,"i":0},{
"key":"AJ","x":1,"y":2,"s":1,"i":0},{
"key":"B","x":1,"y":4,"s":1,"i":0},{
"key":"B","x":1,"y":5,"s":1,"i":0},{
"key":"CJ","x":1,"y":7,"s":1,"i":0},{
"key":"B","x":1,"y":9,"s":1,"i":0},{
"key":"BJ","x":2,"y":1,"s":1,"i":0},{
"key":"A","x":2,"y":3,"s":1,"i":0},{
"key":"BJ","x":2,"y":5,"s":1,"i":0},{
"key":"C","x":2,"y":7,"s":1,"i":0},{
"key":"BJ","x":2,"y":9,"s":1,"i":0},{
"key":"F","x":3,"y":0,"s":1,"i":0},{
"key":"B","x":3,"y":1,"s":1,"i":0},{
"key":"F","x":3,"y":3,"s":1,"i":0},{
"key":"F","x":3,"y":6,"s":1,"i":0},{
"key":"B","x":3,"y":8,"s":1,"i":0},{
"key":"F","x":3,"y":9,"s":1,"i":0},{
"key":"C","x":4,"y":0,"s":1,"i":0},{
"key":"F","x":4,"y":2,"s":1,"i":0},{
"key":"A","x":4,"y":4,"s":1,"i":0},{
"key":"C","x":4,"y":6,"s":1,"i":0},{
"key":"F","x":4,"y":8,"s":1,"i":0},{
"key":"A","x":4,"y":10,"s":1,"i":0},{
"key":"C","x":5,"y":0,"s":1,"i":0},{
"key":"B","x":5,"y":2,"s":1,"i":0},{
"key":"A","x":5,"y":4,"s":1,"i":0},{
"key":"C","x":5,"y":5,"s":1,"i":0},{
"key":"B","x":5,"y":7,"s":1,"i":0},{
"key":"A","x":5,"y":9,"s":1,"i":0},{
"key":"C","x":6,"y":1,"s":1,"i":0},{
"key":"B","x":6,"y":3,"s":1,"i":0},{
"key":"B","x":6,"y":7,"s":1,"i":0},{
"key":"A","x":6,"y":9,"s":1,"i":0},{
"key":"CJ","x":7,"y":1,"s":1,"i":0},{
"key":"B","x":7,"y":3,"s":1,"i":0},{
"key":"B","x":7,"y":6,"s":1,"i":0},{
"key":"AJ","x":7,"y":8,"s":1,"i":0},{
"key":"F","x":8,"y":2,"s":1,"i":0},{
"key":"F","x":8,"y":4,"s":1,"i":0},{
"key":"F","x":8,"y":6,"s":1,"i":0},{
"key":"F","x":8,"y":8,"s":1,"i":0},{
"key":"C","x":9,"y":2,"s":1,"i":0},{
"key":"B","x":9,"y":4,"s":1,"i":0},{
"key":"B","x":9,"y":5,"s":1,"i":0},{
"key":"A","x":9,"y":7,"s":1,"i":0},{
"key":"C","x":10,"y":3,"s":1,"i":0},{
"key":"A","x":10,"y":7,"s":1,"i":0},{
"key":"C","x":11,"y":3,"s":1,"i":0},{
"key":"B","x":11,"y":4,"s":1,"i":0},{
"key":"B","x":11,"y":5,"s":1,"i":0},{
"key":"A","x":11,"y":6,"s":1,"i":0},{
"key":"H","x":12,"y":0,"s":1,"i":0},{
"key":"H","x":12,"y":1,"s":1,"i":0},{
"key":"H","x":12,"y":2,"s":1,"i":0},{
"key":"H","x":12,"y":3,"s":1,"i":0},{
"key":"H","x":12,"y":4,"s":1,"i":0},{
"key":"H","x":12,"y":5,"s":1,"i":0},{
"key":"H","x":12,"y":6,"s":1,"i":0},{
"key":"H","x":12,"y":7,"s":1,"i":0},{
"key":"H","x":12,"y":8,"s":1,"i":0},{
"key":"H","x":12,"y":9,"s":1,"i":0},{
"key":"H","x":12,"y":10,"s":1,"i":0},{
"key":"BBB","x":13,"y":3,"s":1,"i":0},{
"key":"BBB","x":13,"y":4,"s":1,"i":0},{
"key":"BBB","x":13,"y":5,"s":1,"i":0},{
"key":"BBB","x":13,"y":6,"s":1,"i":0},{
"key":"H","x":14,"y":0,"s":1,"i":0},{
"key":"H","x":14,"y":1,"s":1,"i":0},{
"key":"H","x":14,"y":2,"s":1,"i":0},{
"key":"H","x":14,"y":3,"s":1,"i":0},{
"key":"H","x":14,"y":4,"s":1,"i":0},{
"key":"H","x":14,"y":5,"s":1,"i":0},{
"key":"H","x":14,"y":6,"s":1,"i":0},{
"key":"H","x":14,"y":7,"s":1,"i":0},{
"key":"H","x":14,"y":8,"s":1,"i":0},{
"key":"H","x":14,"y":9,"s":1,"i":0},{
"key":"H","x":14,"y":10,"s":1,"i":0},{
"key":"C","x":15,"y":0,"s":1,"i":0},{
"key":"C","x":15,"y":1,"s":1,"i":0},{
"key":"C","x":15,"y":2,"s":1,"i":0},{
"key":"C","x":15,"y":3,"s":1,"i":0},{
"key":"C","x":15,"y":4,"s":1,"i":0},{
"key":"C","x":15,"y":5,"s":1,"i":0},{
"key":"C","x":15,"y":6,"s":1,"i":0},{
"key":"C","x":15,"y":7,"s":1,"i":0},{
"key":"C","x":15,"y":8,"s":1,"i":0},{
"key":"C","x":15,"y":9,"s":1,"i":0},{
"key":"H","x":16,"y":0,"s":1,"i":0},{
"key":"H","x":16,"y":1,"s":1,"i":0},{
"key":"H","x":16,"y":2,"s":1,"i":0},{
"key":"H","x":16,"y":3,"s":1,"i":0},{
"key":"H","x":16,"y":4,"s":1,"i":0},{
"key":"C","x":16,"y":5,"s":1,"i":0},{
"key":"H","x":16,"y":6,"s":1,"i":0},{
"key":"H","x":16,"y":7,"s":1,"i":0},{
"key":"H","x":16,"y":8,"s":1,"i":0},{
"key":"H","x":16,"y":9,"s":1,"i":0},{
"key":"H","x":16,"y":10,"s":1,"i":0},{
"key":"@","x":17,"y":0,"s":1,"i":0},{
"key":"@","x":17,"y":1,"s":1,"i":0},{
"key":"@","x":17,"y":2,"s":1,"i":0},{
"key":"H","x":17,"y":3,"s":1,"i":0},{
"key":"C","x":17,"y":4,"s":1,"i":0},{
"key":"C","x":17,"y":5,"s":1,"i":0},{
"key":"H","x":17,"y":6,"s":1,"i":0},{
"key":"@","x":17,"y":7,"s":1,"i":0},{
"key":"@","x":17,"y":8,"s":1,"i":0},{
"key":"@","x":17,"y":9,"s":1,"i":0},{
"key":"@","x":18,"y":0,"s":1,"i":0},{
"key":"@","x":18,"y":1,"s":1,"i":0},{
"key":"@","x":18,"y":2,"s":1,"i":0},{
"key":"@","x":18,"y":3,"s":1,"i":0},{
"key":"H","x":18,"y":4,"s":1,"i":0},{
"key":"C","x":18,"y":5,"s":1,"i":0},{
"key":"H","x":18,"y":6,"s":1,"i":0},{
"key":"@","x":18,"y":7,"s":1,"i":0},{
"key":"@","x":18,"y":8,"s":1,"i":0},{
"key":"@","x":18,"y":9,"s":1,"i":0},{
"key":"@","x":18,"y":10,"s":1,"i":0},{
"key":"@","x":19,"y":0,"s":1,"i":0},{
"key":"@","x":19,"y":1,"s":1,"i":0},{
"key":"@","x":19,"y":2,"s":1,"i":0},{
"key":"H","x":19,"y":3,"s":1,"i":0},{
"key":"C","x":19,"y":4,"s":1,"i":0},{
"key":"C","x":19,"y":5,"s":1,"i":0},{
"key":"H","x":19,"y":6,"s":1,"i":0},{
"key":"@","x":19,"y":7,"s":1,"i":0},{
"key":"@","x":19,"y":8,"s":1,"i":0},{
"key":"@","x":19,"y":9,"s":1,"i":0},{
"key":"@","x":20,"y":0,"s":1,"i":0},{
"key":"@","x":20,"y":1,"s":1,"i":0},{
"key":"@","x":20,"y":2,"s":1,"i":0},{
"key":"@","x":20,"y":3,"s":1,"i":0},{
"key":"H","x":20,"y":4,"s":1,"i":0},{
"key":"C","x":20,"y":5,"s":1,"i":0},{
"key":"H","x":20,"y":6,"s":1,"i":0},{
"key":"@","x":20,"y":7,"s":1,"i":0},{
"key":"@","x":20,"y":8,"s":1,"i":0},{
"key":"@","x":20,"y":9,"s":1,"i":0},{
"key":"@","x":20,"y":10,"s":1,"i":0},{
"key":"@","x":21,"y":0,"s":1,"i":0},{
"key":"@","x":21,"y":1,"s":1,"i":0},{
"key":"@","x":21,"y":2,"s":1,"i":0},{
"key":"H","x":21,"y":3,"s":1,"i":0},{
"key":"C","x":21,"y":4,"s":1,"i":0},{
"key":"C","x":21,"y":5,"s":1,"i":0},{
"key":"H","x":21,"y":6,"s":1,"i":0},{
"key":"@","x":21,"y":7,"s":1,"i":0},{
"key":"@","x":21,"y":8,"s":1,"i":0},{
"key":"@","x":21,"y":9,"s":1,"i":0},{
"key":"H","x":22,"y":0,"s":1,"i":0},{
"key":"H","x":22,"y":1,"s":1,"i":0},{
"key":"H","x":22,"y":2,"s":1,"i":0},{
"key":"H","x":22,"y":3,"s":1,"i":0},{
"key":"H","x":22,"y":4,"s":1,"i":0},{
"key":"C","x":22,"y":5,"s":1,"i":0},{
"key":"H","x":22,"y":6,"s":1,"i":0},{
"key":"H","x":22,"y":7,"s":1,"i":0},{
"key":"H","x":22,"y":8,"s":1,"i":0},{
"key":"H","x":22,"y":9,"s":1,"i":0},{
"key":"H","x":22,"y":10,"s":1,"i":0},{
"key":"C","x":23,"y":0,"s":1,"i":0},{
"key":"C","x":23,"y":1,"s":1,"i":0},{
"key":"C","x":23,"y":2,"s":1,"i":0},{
"key":"C","x":23,"y":3,"s":1,"i":0},{
"key":"C","x":23,"y":4,"s":1,"i":0},{
"key":"C","x":23,"y":5,"s":1,"i":0},{
"key":"C","x":23,"y":6,"s":1,"i":0},{
"key":"C","x":23,"y":7,"s":1,"i":0},{
"key":"C","x":23,"y":8,"s":1,"i":0},{
"key":"C","x":23,"y":9,"s":1,"i":0}],"sub
":[],"down
":[],"jysub

":[]}