{
"BackCround":{
"backCround_type":1,"bottom_type":2,"skill_type":0},"level":99,"mode":1,"LevelType":{
"Key":"@","Type":1,"Number":9},"Star":{
"star1":10000,"star2":38000,"star3":75000},"Gang":{
"Gang1":1,"Gang2":0,"Gang3":1,"Gang4":1,"Gang5":1},"ReadyBubble":{
"R1":0,"R2":0,"R3":0,"R4":0},"BallNumber":36,"TimeLimit":0,"ObjChance":[{
"Key":"C","P":4},{
"Key":"A","P":4},{
"Key":"B","P":4},{
"Key":"D","P":4}],"top":[],"bubble
":[{
"key":"B","x":0,"y":1,"s":1,"i":0},{
"key":"D","x":0,"y":2,"s":1,"i":0},{
"key":"D","x":0,"y":3,"s":1,"i":0},{
"key":"A","x":0,"y":7,"s":1,"i":0},{
"key":"A","x":0,"y":8,"s":1,"i":0},{
"key":"C","x":0,"y":9,"s":1,"i":0},{
"key":"B","x":1,"y":0,"s":1,"i":0},{
"key":"BJ","x":1,"y":1,"s":1,"i":0},{
"key":"D","x":1,"y":2,"s":1,"i":0},{
"key":"DJ","x":1,"y":3,"s":1,"i":0},{
"key":"AJ","x":1,"y":6,"s":1,"i":0},{
"key":"A","x":1,"y":7,"s":1,"i":0},{
"key":"CJ","x":1,"y":8,"s":1,"i":0},{
"key":"C","x":1,"y":9,"s":1,"i":0},{
"key":"B","x":2,"y":1,"s":1,"i":0},{
"key":"B","x":2,"y":2,"s":1,"i":0},{
"key":"D","x":2,"y":3,"s":1,"i":0},{
"key":"D","x":2,"y":4,"s":1,"i":0},{
"key":"A","x":2,"y":6,"s":1,"i":0},{
"key":"A","x":2,"y":7,"s":1,"i":0},{
"key":"C","x":2,"y":8,"s":1,"i":0},{
"key":"C","x":2,"y":9,"s":1,"i":0},{
"key":"D1","x":3,"y":0,"s":1,"i":0},{
"key":"D1","x":3,"y":1,"s":1,"i":0},{
"key":"D1","x":3,"y":2,"s":1,"i":0},{
"key":"D1","x":3,"y":3,"s":1,"i":0},{
"key":"D1","x":3,"y":4,"s":1,"i":0},{
"key":"D1","x":3,"y":5,"s":1,"i":0},{
"key":"D1","x":3,"y":6,"s":1,"i":0},{
"key":"D1","x":3,"y":7,"s":1,"i":0},{
"key":"D1","x":3,"y":8,"s":1,"i":0},{
"key":"D1","x":3,"y":9,"s":1,"i":0},{
"key":"B","x":4,"y":2,"s":1,"i":0},{
"key":"B","x":4,"y":3,"s":1,"i":0},{
"key":"A","x":4,"y":4,"s":1,"i":0},{
"key":"A","x":4,"y":5,"s":1,"i":0},{
"key":"D","x":4,"y":6,"s":1,"i":0},{
"key":"D","x":4,"y":7,"s":1,"i":0},{
"key":"A","x":4,"y":8,"s":1,"i":0},{
"key":"B","x":5,"y":1,"s":1,"i":0},{
"key":"B","x":5,"y":2,"s":1,"i":0},{
"key":"B","x":5,"y":3,"s":1,"i":0},{
"key":"A","x":5,"y":4,"s":1,"i":0},{
"key":"A","x":5,"y":5,"s":1,"i":0},{
"key":"D","x":5,"y":6,"s":1,"i":0},{
"key":"D","x":5,"y":7,"s":1,"i":0},{
"key":"A","x":5,"y":8,"s":1,"i":0},{
"key":"A","x":6,"y":2,"s":1,"i":0},{
"key":"A","x":6,"y":3,"s":1,"i":0},{
"key":"C","x":6,"y":4,"s":1,"i":0},{
"key":"CJ","x":6,"y":5,"s":1,"i":0},{
"key":"C","x":6,"y":6,"s":1,"i":0},{
"key":"D","x":6,"y":7,"s":1,"i":0},{
"key":"B","x":6,"y":8,"s":1,"i":0},{
"key":"A","x":7,"y":1,"s":1,"i":0},{
"key":"A","x":7,"y":2,"s":1,"i":0},{
"key":"A","x":7,"y":3,"s":1,"i":0},{
"key":"C","x":7,"y":4,"s":1,"i":0},{
"key":"C","x":7,"y":5,"s":1,"i":0},{
"key":"B","x":7,"y":6,"s":1,"i":0},{
"key":"B","x":7,"y":7,"s":1,"i":0},{
"key":"B","x":7,"y":8,"s":1,"i":0},{
"key":"D","x":8,"y":2,"s":1,"i":0},{
"key":"D","x":8,"y":3,"s":1,"i":0},{
"key":"D1","x":8,"y":4,"s":1,"i":0},{
"key":"BBB","x":8,"y":5,"s":1,"i":0},{
"key":"D1","x":8,"y":6,"s":1,"i":0},{
"key":"A","x":8,"y":7,"s":1,"i":0},{
"key":"B","x":8,"y":8,"s":1,"i":0},{
"key":"D","x":9,"y":1,"s":1,"i":0},{
"key":"D","x":9,"y":2,"s":1,"i":0},{
"key":"C","x":9,"y":3,"s":1,"i":0},{
"key":"A","x":9,"y":6,"s":1,"i":0},{
"key":"A","x":9,"y":7,"s":1,"i":0},{
"key":"B","x":9,"y":8,"s":1,"i":0},{
"key":"BBB","x":10,"y":1,"s":1,"i":0},{
"key":"BBB","x":10,"y":2,"s":1,"i":0},{
"key":"C","x":10,"y":3,"s":1,"i":0},{
"key":"C","x":10,"y":4,"s":1,"i":0},{
"key":"B","x":10,"y":6,"s":1,"i":0},{
"key":"BBB","x":10,"y":7,"s":1,"i":0},{
"key":"BBB","x":10,"y":8,"s":1,"i":0},{
"key":"C","x":10,"y":9,"s":1,"i":0},{
"key":"A","x":11,"y":1,"s":1,"i":0},{
"key":"A","x":11,"y":2,"s":1,"i":0},{
"key":"DJ","x":11,"y":3,"s":1,"i":0},{
"key":"D","x":11,"y":4,"s":1,"i":0},{
"key":"E1","x":11,"y":5,"s":1,"i":0},{
"key":"BJ","x":11,"y":6,"s":1,"i":0},{
"key":"B","x":11,"y":7,"s":1,"i":0},{
"key":"C","x":11,"y":8,"s":1,"i":0},{
"key":"A","x":12,"y":2,"s":1,"i":0},{
"key":"B","x":12,"y":3,"s":1,"i":0},{
"key":"D","x":12,"y":4,"s":1,"i":0},{
"key":"D","x":12,"y":5,"s":1,"i":0},{
"key":"A","x":12,"y":6,"s":1,"i":0},{
"key":"A","x":12,"y":7,"s":1,"i":0},{
"key":"C","x":12,"y":8,"s":1,"i":0},{
"key":"B","x":13,"y":2,"s":1,"i":0},{
"key":"B","x":13,"y":3,"s":1,"i":0},{
"key":"A","x":13,"y":4,"s":1,"i":0},{
"key":"C","x":13,"y":5,"s":1,"i":0},{
"key":"D","x":13,"y":6,"s":1,"i":0},{
"key":"A","x":13,"y":7,"s":1,"i":0},{
"key":"D","x":14,"y":2,"s":1,"i":0},{
"key":"A","x":14,"y":3,"s":1,"i":0},{
"key":"A","x":14,"y":4,"s":1,"i":0},{
"key":"C","x":14,"y":5,"s":1,"i":0},{
"key":"C","x":14,"y":6,"s":1,"i":0},{
"key":"D","x":14,"y":7,"s":1,"i":0},{
"key":"D","x":14,"y":8,"s":1,"i":0},{
"key":"D","x":15,"y":1,"s":1,"i":0},{
"key":"D","x":15,"y":2,"s":1,"i":0},{
"key":"D","x":15,"y":3,"s":1,"i":0},{
"key":"B","x":15,"y":4,"s":1,"i":0},{
"key":"C","x":15,"y":5,"s":1,"i":0},{
"key":"C","x":15,"y":6,"s":1,"i":0},{
"key":"A","x":15,"y":7,"s":1,"i":0},{
"key":"B","x":15,"y":8,"s":1,"i":0},{
"key":"D","x":16,"y":1,"s":1,"i":0},{
"key":"C","x":16,"y":2,"s":1,"i":0},{
"key":"C","x":16,"y":3,"s":1,"i":0},{
"key":"B","x":16,"y":4,"s":1,"i":0},{
"key":"BJ","x":16,"y":5,"s":1,"i":0},{
"key":"D","x":16,"y":6,"s":1,"i":0},{
"key":"A","x":16,"y":7,"s":1,"i":0},{
"key":"A","x":16,"y":8,"s":1,"i":0},{
"key":"B","x":16,"y":9,"s":1,"i":0},{
"key":"B","x":17,"y":0,"s":1,"i":0},{
"key":"C","x":17,"y":1,"s":1,"i":0},{
"key":"C","x":17,"y":2,"s":1,"i":0},{
"key":"B","x":17,"y":3,"s":1,"i":0},{
"key":"B","x":17,"y":4,"s":1,"i":0},{
"key":"D","x":17,"y":5,"s":1,"i":0},{
"key":"D","x":17,"y":6,"s":1,"i":0},{
"key":"A","x":17,"y":7,"s":1,"i":0},{
"key":"A","x":17,"y":8,"s":1,"i":0},{
"key":"C","x":17,"y":9,"s":1,"i":0},{
"key":"B","x":18,"y":1,"s":1,"i":0},{
"key":"B","x":18,"y":2,"s":1,"i":0},{
"key":"A","x":18,"y":3,"s":1,"i":0},{
"key":"A","x":18,"y":4,"s":1,"i":0},{
"key":"AJ","x":18,"y":5,"s":1,"i":0},{
"key":"D","x":18,"y":6,"s":1,"i":0},{
"key":"D","x":18,"y":7,"s":1,"i":0},{
"key":"C","x":18,"y":8,"s":1,"i":0},{
"key":"C","x":18,"y":9,"s":1,"i":0},{
"key":"C","x":19,"y":1,"s":1,"i":0},{
"key":"C","x":19,"y":2,"s":1,"i":0},{
"key":"B","x":19,"y":7,"s":1,"i":0},{
"key":"B","x":19,"y":8,"s":1,"i":0},{
"key":"C","x":20,"y":1,"s":1,"i":0},{
"key":"C","x":20,"y":2,"s":1,"i":0},{
"key":"A","x":20,"y":3,"s":1,"i":0},{
"key":"A","x":20,"y":4,"s":1,"i":0},{
"key":"A","x":20,"y":5,"s":1,"i":0},{
"key":"A","x":20,"y":6,"s":1,"i":0},{
"key":"A","x":20,"y":7,"s":1,"i":0},{
"key":"B","x":20,"y":8,"s":1,"i":0},{
"key":"B","x":20,"y":9,"s":1,"i":0},{
"key":"A","x":21,"y":0,"s":1,"i":0},{
"key":"A","x":21,"y":1,"s":1,"i":0},{
"key":"A","x":21,"y":2,"s":1,"i":0},{
"key":"C","x":21,"y":3,"s":1,"i":0},{
"key":"A","x":21,"y":4,"s":1,"i":0},{
"key":"A","x":21,"y":5,"s":1,"i":0},{
"key":"B","x":21,"y":6,"s":1,"i":0},{
"key":"D","x":21,"y":7,"s":1,"i":0},{
"key":"D","x":21,"y":8,"s":1,"i":0},{
"key":"D","x":21,"y":9,"s":1,"i":0},{
"key":"D","x":22,"y":1,"s":1,"i":0},{
"key":"D","x":22,"y":2,"s":1,"i":0},{
"key":"C","x":22,"y":3,"s":1,"i":0},{
"key":"C","x":22,"y":4,"s":1,"i":0},{
"key":"D","x":22,"y":5,"s":1,"i":0},{
"key":"B","x":22,"y":6,"s":1,"i":0},{
"key":"B","x":22,"y":7,"s":1,"i":0},{
"key":"A","x":22,"y":8,"s":1,"i":0},{
"key":"A","x":22,"y":9,"s":1,"i":0},{
"key":"D","x":23,"y":2,"s":1,"i":0},{
"key":"C","x":23,"y":3,"s":1,"i":0},{
"key":"D","x":23,"y":4,"s":1,"i":0},{
"key":"D","x":23,"y":5,"s":1,"i":0},{
"key":"B","x":23,"y":6,"s":1,"i":0},{
"key":"A","x":23,"y":7,"s":1,"i":0}],"sub
":[{
"key":"L","x":5,"y":3,"s":0,"i":0},{
"key":"L","x":5,"y":4,"s":0,"i":0},{
"key":"L","x":5,"y":5,"s":0,"i":0},{
"key":"L","x":5,"y":6,"s":0,"i":0},{
"key":"Suo","x":5,"y":7,"s":0,"i":0},{
"key":"L","x":5,"y":8,"s":0,"i":0},{
"key":"L","x":13,"y":3,"s":0,"i":0},{
"key":"L","x":13,"y":4,"s":0,"i":0},{
"key":"Suo","x":13,"y":5,"s":0,"i":0},{
"key":"L","x":13,"y":6,"s":0,"i":0},{
"key":"S","x":14,"y":3,"s":0,"i":0},{
"key":"S","x":14,"y":4,"s":0,"i":0},{
"key":"S","x":14,"y":5,"s":0,"i":0},{
"key":"S","x":14,"y":6,"s":0,"i":0},{
"key":"S","x":14,"y":7,"s":0,"i":0},{
"key":"S","x":15,"y":2,"s":0,"i":0},{
"key":"S","x":15,"y":3,"s":0,"i":0},{
"key":"S","x":15,"y":4,"s":0,"i":0},{
"key":"S","x":15,"y":5,"s":0,"i":0},{
"key":"S","x":15,"y":6,"s":0,"i":0},{
"key":"S","x":15,"y":7,"s":0,"i":0},{
"key":"S","x":16,"y":2,"s":0,"i":0},{
"key":"S","x":16,"y":3,"s":0,"i":0},{
"key":"S","x":16,"y":4,"s":0,"i":0},{
"key":"S","x":16,"y":6,"s":0,"i":0},{
"key":"S","x":16,"y":7,"s":0,"i":0},{
"key":"S","x":16,"y":8,"s":0,"i":0},{
"key":"S","x":17,"y":1,"s":0,"i":0},{
"key":"S","x":17,"y":2,"s":0,"i":0},{
"key":"S","x":17,"y":3,"s":0,"i":0},{
"key":"S","x":17,"y":6,"s":0,"i":0},{
"key":"S","x":17,"y":7,"s":0,"i":0},{
"key":"S","x":17,"y":8,"s":0,"i":0},{
"key":"L","x":20,"y":4,"s":0,"i":0},{
"key":"Suo","x":20,"y":5,"s":0,"i":0},{
"key":"L","x":20,"y":6,"s":0,"i":0}],"down
":[],"jysub

":[]}