{
"BackCround":{
"backCround_type":1,"bottom_type":2,"skill_type":0},"level":591,"mode":1,"LevelType":{
"Key":"@","Type":1,"Number":4},"Star":{
"star1":120,"star2":50000,"star3":70000},"Gang":{
"Gang1":1,"Gang2":0,"Gang3":1,"Gang4":0,"Gang5":0},"BallNumber":29,"TimeLimit":0,"ObjChance":[{
"Key":"C","P":4},{
"Key":"A","P":4},{
"Key":"B","P":4}],"top":[],"bubble
":[{
"key":"K","x":0,"y":1,"s":1,"i":0},{
"key":"C1","x":0,"y":2,"s":1,"i":0},{
"key":"C1","x":0,"y":3,"s":1,"i":0},{
"key":"C1","x":0,"y":7,"s":1,"i":0},{
"key":"C1","x":0,"y":8,"s":1,"i":0},{
"key":"C1","x":0,"y":9,"s":1,"i":0},{
"key":"C1","x":1,"y":0,"s":1,"i":0},{
"key":"C1","x":1,"y":1,"s":1,"i":0},{
"key":"C1","x":1,"y":2,"s":1,"i":0},{
"key":"C1","x":1,"y":3,"s":1,"i":0},{
"key":"C1","x":1,"y":6,"s":1,"i":0},{
"key":"C1","x":1,"y":7,"s":1,"i":0},{
"key":"C1","x":1,"y":8,"s":1,"i":0},{
"key":"C1","x":1,"y":9,"s":1,"i":0},{
"key":"C1","x":2,"y":0,"s":1,"i":0},{
"key":"DJ","x":2,"y":1,"s":1,"i":0},{
"key":"C1","x":2,"y":2,"s":1,"i":0},{
"key":"EJ","x":2,"y":3,"s":1,"i":0},{
"key":"K","x":2,"y":4,"s":1,"i":0},{
"key":"C1","x":2,"y":6,"s":1,"i":0},{
"key":"DJ","x":2,"y":7,"s":1,"i":0},{
"key":"K","x":2,"y":8,"s":1,"i":0},{
"key":"EJ","x":2,"y":9,"s":1,"i":0},{
"key":"C1","x":2,"y":10,"s":1,"i":0},{
"key":"C1","x":3,"y":0,"s":1,"i":0},{
"key":"C1","x":3,"y":1,"s":1,"i":0},{
"key":"C1","x":3,"y":2,"s":1,"i":0},{
"key":"C1","x":3,"y":3,"s":1,"i":0},{
"key":"C1","x":3,"y":6,"s":1,"i":0},{
"key":"K","x":3,"y":7,"s":1,"i":0},{
"key":"K","x":3,"y":8,"s":1,"i":0},{
"key":"C1","x":3,"y":9,"s":1,"i":0},{
"key":"C1","x":4,"y":1,"s":1,"i":0},{
"key":"K","x":4,"y":2,"s":1,"i":0},{
"key":"C1","x":4,"y":3,"s":1,"i":0},{
"key":"C1","x":4,"y":7,"s":1,"i":0},{
"key":"C1","x":4,"y":8,"s":1,"i":0},{
"key":"C1","x":4,"y":9,"s":1,"i":0},{
"key":"I","x":5,"y":3,"s":1,"i":0},{
"key":"I","x":5,"y":6,"s":1,"i":0},{
"key":"I","x":6,"y":4,"s":1,"i":0},{
"key":"I","x":6,"y":6,"s":1,"i":0},{
"key":"I","x":7,"y":4,"s":1,"i":0},{
"key":"I","x":7,"y":5,"s":1,"i":0},{
"key":"I","x":8,"y":5,"s":1,"i":0},{
"key":"I","x":9,"y":4,"s":1,"i":0},{
"key":"I","x":9,"y":5,"s":1,"i":0},{
"key":"@","x":10,"y":1,"s":1,"i":0},{
"key":"F","x":10,"y":2,"s":1,"i":0},{
"key":"A","x":10,"y":3,"s":1,"i":0},{
"key":"I","x":10,"y":4,"s":1,"i":0},{
"key":"I","x":10,"y":6,"s":1,"i":0},{
"key":"B","x":10,"y":7,"s":1,"i":0},{
"key":"B","x":10,"y":8,"s":1,"i":0},{
"key":"C","x":10,"y":9,"s":1,"i":0},{
"key":"@","x":11,"y":0,"s":1,"i":0},{
"key":"F","x":11,"y":1,"s":1,"i":0},{
"key":"A","x":11,"y":2,"s":1,"i":0},{
"key":"I","x":11,"y":3,"s":1,"i":0},{
"key":"I","x":11,"y":6,"s":1,"i":0},{
"key":"A","x":11,"y":7,"s":1,"i":0},{
"key":"@","x":11,"y":8,"s":1,"i":0},{
"key":"C","x":11,"y":9,"s":1,"i":0},{
"key":"@","x":12,"y":0,"s":1,"i":0},{
"key":"@","x":12,"y":1,"s":1,"i":0},{
"key":"F","x":12,"y":2,"s":1,"i":0},{
"key":"C","x":12,"y":3,"s":1,"i":0},{
"key":"B","x":12,"y":4,"s":1,"i":0},{
"key":"A","x":12,"y":6,"s":1,"i":0},{
"key":"@","x":12,"y":7,"s":1,"i":0},{
"key":"L","x":12,"y":8,"s":1,"i":0},{
"key":"@","x":12,"y":9,"s":1,"i":0},{
"key":"B","x":12,"y":10,"s":1,"i":0},{
"key":"C","x":13,"y":0,"s":1,"i":0},{
"key":"O","x":13,"y":1,"s":1,"i":0},{
"key":"F","x":13,"y":2,"s":1,"i":0},{
"key":"F","x":13,"y":3,"s":1,"i":0},{
"key":"C","x":13,"y":6,"s":1,"i":0},{
"key":"@","x":13,"y":7,"s":1,"i":0},{
"key":"@","x":13,"y":8,"s":1,"i":0},{
"key":"B","x":13,"y":9,"s":1,"i":0},{
"key":"C","x":14,"y":1,"s":1,"i":0},{
"key":"A","x":14,"y":2,"s":1,"i":0},{
"key":"A","x":14,"y":3,"s":1,"i":0},{
"key":"C","x":14,"y":7,"s":1,"i":0},{
"key":"A","x":14,"y":8,"s":1,"i":0},{
"key":"A","x":14,"y":9,"s":1,"i":0},{
"key":"H","x":15,"y":3,"s":1,"i":0},{
"key":"H","x":15,"y":6,"s":1,"i":0},{
"key":"H","x":16,"y":4,"s":1,"i":0},{
"key":"H","x":16,"y":6,"s":1,"i":0},{
"key":"H","x":17,"y":4,"s":1,"i":0},{
"key":"H","x":17,"y":5,"s":1,"i":0},{
"key":"H","x":18,"y":5,"s":1,"i":0},{
"key":"K","x":19,"y":1,"s":1,"i":0},{
"key":"C1","x":19,"y":2,"s":1,"i":0},{
"key":"@","x":19,"y":3,"s":1,"i":0},{
"key":"H","x":19,"y":4,"s":1,"i":0},{
"key":"H","x":19,"y":5,"s":1,"i":0},{
"key":"K","x":19,"y":6,"s":1,"i":0},{
"key":"@","x":19,"y":7,"s":1,"i":0},{
"key":"@","x":19,"y":8,"s":1,"i":0},{
"key":"@","x":20,"y":1,"s":1,"i":0},{
"key":"C1","x":20,"y":2,"s":1,"i":0},{
"key":"K","x":20,"y":3,"s":1,"i":0},{
"key":"H","x":20,"y":4,"s":1,"i":0},{
"key":"H","x":20,"y":6,"s":1,"i":0},{
"key":"C1","x":20,"y":7,"s":1,"i":0},{
"key":"C1","x":20,"y":8,"s":1,"i":0},{
"key":"@","x":20,"y":9,"s":1,"i":0},{
"key":"@","x":21,"y":0,"s":1,"i":0},{
"key":"C1","x":21,"y":1,"s":1,"i":0},{
"key":"K","x":21,"y":2,"s":1,"i":0},{
"key":"H","x":21,"y":3,"s":1,"i":0},{
"key":"@","x":21,"y":4,"s":1,"i":0},{
"key":"@","x":21,"y":5,"s":1,"i":0},{
"key":"H","x":21,"y":6,"s":1,"i":0},{
"key":"C1","x":21,"y":7,"s":1,"i":0},{
"key":"K","x":21,"y":8,"s":1,"i":0},{
"key":"@","x":21,"y":9,"s":1,"i":0},{
"key":"K","x":22,"y":1,"s":1,"i":0},{
"key":"C1","x":22,"y":2,"s":1,"i":0},{
"key":"C1","x":22,"y":3,"s":1,"i":0},{
"key":"@","x":22,"y":4,"s":1,"i":0},{
"key":"@","x":22,"y":6,"s":1,"i":0},{
"key":"C1","x":22,"y":7,"s":1,"i":0},{
"key":"C1","x":22,"y":8,"s":1,"i":0},{
"key":"@","x":22,"y":9,"s":1,"i":0},{
"key":"K","x":23,"y":1,"s":1,"i":0},{
"key":"@","x":23,"y":2,"s":1,"i":0},{
"key":"H","x":23,"y":3,"s":1,"i":0},{
"key":"H","x":23,"y":6,"s":1,"i":0},{
"key":"@","x":23,"y":7,"s":1,"i":0},{
"key":"@","x":23,"y":8,"s":1,"i":0},{
"key":"H","x":24,"y":4,"s":1,"i":0},{
"key":"H","x":24,"y":6,"s":1,"i":0},{
"key":"H","x":25,"y":4,"s":1,"i":0},{
"key":"H","x":25,"y":5,"s":1,"i":0},{
"key":"@","x":26,"y":1,"s":1,"i":0},{
"key":"K","x":26,"y":2,"s":1,"i":0},{
"key":"@","x":26,"y":3,"s":1,"i":0},{
"key":"H","x":26,"y":5,"s":1,"i":0},{
"key":"@","x":26,"y":7,"s":1,"i":0},{
"key":"@","x":26,"y":8,"s":1,"i":0},{
"key":"@","x":26,"y":9,"s":1,"i":0},{
"key":"@","x":27,"y":0,"s":1,"i":0},{
"key":"@","x":27,"y":1,"s":1,"i":0},{
"key":"@","x":27,"y":2,"s":1,"i":0},{
"key":"@","x":27,"y":3,"s":1,"i":0},{
"key":"H","x":27,"y":4,"s":1,"i":0},{
"key":"H","x":27,"y":5,"s":1,"i":0},{
"key":"K","x":27,"y":6,"s":1,"i":0},{
"key":"K","x":27,"y":7,"s":1,"i":0},{
"key":"@","x":27,"y":8,"s":1,"i":0},{
"key":"@","x":27,"y":9,"s":1,"i":0},{
"key":"K","x":28,"y":0,"s":1,"i":0},{
"key":"@","x":28,"y":1,"s":1,"i":0},{
"key":"K","x":28,"y":2,"s":1,"i":0},{
"key":"B","x":28,"y":3,"s":1,"i":0},{
"key":"H","x":28,"y":4,"s":1,"i":0},{
"key":"H","x":28,"y":6,"s":1,"i":0},{
"key":"@","x":28,"y":7,"s":1,"i":0},{
"key":"@","x":28,"y":8,"s":1,"i":0},{
"key":"@","x":28,"y":9,"s":1,"i":0},{
"key":"K","x":28,"y":10,"s":1,"i":0},{
"key":"@","x":29,"y":0,"s":1,"i":0},{
"key":"@","x":29,"y":1,"s":1,"i":0},{
"key":"C","x":29,"y":2,"s":1,"i":0},{
"key":"H","x":29,"y":3,"s":1,"i":0},{
"key":"H","x":29,"y":6,"s":1,"i":0},{
"key":"A","x":29,"y":7,"s":1,"i":0},{
"key":"C","x":29,"y":8,"s":1,"i":0},{
"key":"@","x":29,"y":9,"s":1,"i":0},{
"key":"@","x":30,"y":1,"s":1,"i":0},{
"key":"C","x":30,"y":2,"s":1,"i":0},{
"key":"B","x":30,"y":3,"s":1,"i":0},{
"key":"C","x":30,"y":7,"s":1,"i":0},{
"key":"A","x":30,"y":8,"s":1,"i":0},{
"key":"@","x":30,"y":9,"s":1,"i":0},{
"key":"H","x":31,"y":3,"s":1,"i":0},{
"key":"H","x":31,"y":6,"s":1,"i":0},{
"key":"H","x":32,"y":4,"s":1,"i":0},{
"key":"H","x":32,"y":6,"s":1,"i":0},{
"key":"H","x":33,"y":4,"s":1,"i":0},{
"key":"H","x":33,"y":5,"s":1,"i":0},{
"key":"H","x":34,"y":5,"s":1,"i":0},{
"key":"@","x":35,"y":3,"s":1,"i":0},{
"key":"@","x":35,"y":4,"s":1,"i":0},{
"key":"@","x":35,"y":5,"s":1,"i":0},{
"key":"F","x":35,"y":6,"s":1,"i":0},{
"key":"F","x":36,"y":3,"s":1,"i":0},{
"key":"C","x":36,"y":4,"s":1,"i":0},{
"key":"K","x":36,"y":5,"s":1,"i":0},{
"key":"@","x":36,"y":6,"s":1,"i":0},{
"key":"K","x":36,"y":7,"s":1,"i":0},{
"key":"K","x":37,"y":2,"s":1,"i":0},{
"key":"C","x":37,"y":3,"s":1,"i":0},{
"key":"C","x":37,"y":4,"s":1,"i":0},{
"key":"A","x":37,"y":5,"s":1,"i":0},{
"key":"A","x":37,"y":6,"s":1,"i":0},{
"key":"@","x":37,"y":7,"s":1,"i":0},{
"key":"A","x":38,"y":2,"s":1,"i":0},{
"key":"@","x":38,"y":3,"s":1,"i":0},{
"key":"K","x":38,"y":4,"s":1,"i":0},{
"key":"F","x":38,"y":5,"s":1,"i":0},{
"key":"F","x":38,"y":6,"s":1,"i":0},{
"key":"A","x":38,"y":7,"s":1,"i":0},{
"key":"F","x":38,"y":8,"s":1,"i":0},{
"key":"A","x":39,"y":2,"s":1,"i":0},{
"key":"B","x":39,"y":3,"s":1,"i":0},{
"key":"K","x":39,"y":4,"s":1,"i":0},{
"key":"@","x":39,"y":5,"s":1,"i":0},{
"key":"B","x":39,"y":6,"s":1,"i":0},{
"key":"B","x":39,"y":7,"s":1,"i":0},{
"key":"F","x":40,"y":3,"s":1,"i":0},{
"key":"B","x":40,"y":4,"s":1,"i":0},{
"key":"C","x":40,"y":5,"s":1,"i":0},{
"key":"@","x":40,"y":6,"s":1,"i":0},{
"key":"K","x":40,"y":7,"s":1,"i":0},{
"key":"K","x":41,"y":3,"s":1,"i":0},{
"key":"C","x":41,"y":4,"s":1,"i":0},{
"key":"@","x":41,"y":5,"s":1,"i":0},{
"key":"F","x":41,"y":6,"s":1,"i":0}],"sub
":[]}