{
"BackCround":{
"backCround_type":1,"bottom_type":2,"skill_type":0},"level":903,"mode":1,"LevelType":{
"Key":"@","Type":1,"Number":2},"Star":{
"star1":1000,"star2":5000,"star3":10000},"Gang":{
"Gang1":0,"Gang2":1,"Gang3":0,"Gang4":0,"Gang5":0},"ReadyBubble":{
"R1":0,"R2":0,"R3":0,"R4":0},"BallNumber":20,"TimeLimit":0,"ObjChance":[{
"Key":"C","P":1},{
"Key":"A","P":1},{
"Key":"B","P":1},{
"Key":"E","P":1},{
"Key":"D","P":1}],"top":[],"bubble
":[{
"key":"H","x":0,"y":2,"s":1,"i":0},{
"key":"BJ","x":0,"y":3,"s":1,"i":0},{
"key":"EJ","x":0,"y":7,"s":1,"i":0},{
"key":"H","x":0,"y":8,"s":1,"i":0},{
"key":"A","x":1,"y":2,"s":1,"i":0},{
"key":"H","x":1,"y":3,"s":1,"i":0},{
"key":"H","x":1,"y":6,"s":1,"i":0},{
"key":"C","x":1,"y":7,"s":1,"i":0},{
"key":"H","x":2,"y":2,"s":1,"i":0},{
"key":"E","x":2,"y":4,"s":1,"i":0},{
"key":"H","x":2,"y":5,"s":1,"i":0},{
"key":"B","x":2,"y":6,"s":1,"i":0},{
"key":"H","x":2,"y":8,"s":1,"i":0},{
"key":"A","x":3,"y":2,"s":1,"i":0},{
"key":"A","x":3,"y":7,"s":1,"i":0},{
"key":"E","x":4,"y":0,"s":1,"i":0},{
"key":"H","x":4,"y":1,"s":1,"i":0},{
"key":"B","x":4,"y":2,"s":1,"i":0},{
"key":"H","x":4,"y":3,"s":1,"i":0},{
"key":"C","x":4,"y":4,"s":1,"i":0},{
"key":"H","x":4,"y":5,"s":1,"i":0},{
"key":"D","x":4,"y":6,"s":1,"i":0},{
"key":"H","x":4,"y":7,"s":1,"i":0},{
"key":"E","x":4,"y":8,"s":1,"i":0},{
"key":"H","x":4,"y":9,"s":1,"i":0},{
"key":"C","x":4,"y":10,"s":1,"i":0},{
"key":"D","x":5,"y":2,"s":1,"i":0},{
"key":"E","x":5,"y":3,"s":1,"i":0},{
"key":"A","x":5,"y":6,"s":1,"i":0},{
"key":"C","x":5,"y":7,"s":1,"i":0},{
"key":"H","x":6,"y":3,"s":1,"i":0},{
"key":"B","x":6,"y":4,"s":1,"i":0},{
"key":"B","x":6,"y":6,"s":1,"i":0},{
"key":"H","x":6,"y":7,"s":1,"i":0},{
"key":"A","x":7,"y":2,"s":1,"i":0},{
"key":"E","x":7,"y":4,"s":1,"i":0},{
"key":"D","x":7,"y":5,"s":1,"i":0},{
"key":"C","x":7,"y":7,"s":1,"i":0},{
"key":"H","x":8,"y":2,"s":1,"i":0},{
"key":"H","x":8,"y":5,"s":1,"i":0},{
"key":"H","x":8,"y":8,"s":1,"i":0}],"sub
":[],"down
":[],"jysub

":[]}