{
"BackCround":{
"backCround_type":1,"bottom_type":2,"skill_type":0},"level":559,"mode":1,"LevelType":{
"Key":"@","Type":1,"Number":9},"Star":{
"star1":120,"star2":38020,"star3":50000},"Gang":{
"Gang1":0,"Gang2":1,"Gang3":1,"Gang4":0,"Gang5":0},"BallNumber":29,"TimeLimit":0,"ObjChance":[{
"Key":"C","P":4},{
"Key":"A","P":4},{
"Key":"B","P":4},{
"Key":"E","P":4},{
"Key":"D","P":4}],"top":[],"bubble
":[{
"key":"AJ","x":0,"y":2,"s":1,"i":0},{
"key":"H","x":0,"y":4,"s":1,"i":0},{
"key":"H","x":0,"y":6,"s":1,"i":0},{
"key":"DJ","x":0,"y":8,"s":1,"i":0},{
"key":"B","x":1,"y":1,"s":1,"i":0},{
"key":"AJ","x":1,"y":2,"s":1,"i":0},{
"key":"CJ","x":1,"y":4,"s":1,"i":0},{
"key":"EJ","x":1,"y":5,"s":1,"i":0},{
"key":"DJ","x":1,"y":7,"s":1,"i":0},{
"key":"A","x":1,"y":8,"s":1,"i":0},{
"key":"B","x":2,"y":1,"s":1,"i":0},{
"key":"F","x":2,"y":2,"s":1,"i":0},{
"key":"F","x":2,"y":3,"s":1,"i":0},{
"key":"F","x":2,"y":4,"s":1,"i":0},{
"key":"F","x":2,"y":5,"s":1,"i":0},{
"key":"F","x":2,"y":6,"s":1,"i":0},{
"key":"F","x":2,"y":7,"s":1,"i":0},{
"key":"F","x":2,"y":8,"s":1,"i":0},{
"key":"A","x":2,"y":9,"s":1,"i":0},{
"key":"A","x":3,"y":1,"s":1,"i":0},{
"key":"C","x":3,"y":2,"s":1,"i":0},{
"key":"C","x":3,"y":4,"s":1,"i":0},{
"key":"E","x":3,"y":5,"s":1,"i":0},{
"key":"E","x":3,"y":7,"s":1,"i":0},{
"key":"B","x":3,"y":8,"s":1,"i":0},{
"key":"A","x":4,"y":2,"s":1,"i":0},{
"key":"H","x":4,"y":4,"s":1,"i":0},{
"key":"H","x":4,"y":5,"s":1,"i":0},{
"key":"H","x":4,"y":6,"s":1,"i":0},{
"key":"B","x":4,"y":8,"s":1,"i":0},{
"key":"C1","x":5,"y":1,"s":1,"i":0},{
"key":"C1","x":5,"y":2,"s":1,"i":0},{
"key":"C1","x":5,"y":4,"s":1,"i":0},{
"key":"C1","x":5,"y":5,"s":1,"i":0},{
"key":"C1","x":5,"y":7,"s":1,"i":0},{
"key":"C1","x":5,"y":8,"s":1,"i":0},{
"key":"C1","x":6,"y":1,"s":1,"i":0},{
"key":"C1","x":6,"y":2,"s":1,"i":0},{
"key":"C1","x":6,"y":3,"s":1,"i":0},{
"key":"C1","x":6,"y":4,"s":1,"i":0},{
"key":"C1","x":6,"y":5,"s":1,"i":0},{
"key":"C1","x":6,"y":6,"s":1,"i":0},{
"key":"C1","x":6,"y":7,"s":1,"i":0},{
"key":"C1","x":6,"y":8,"s":1,"i":0},{
"key":"C1","x":6,"y":9,"s":1,"i":0},{
"key":"C1","x":7,"y":1,"s":1,"i":0},{
"key":"C1","x":7,"y":2,"s":1,"i":0},{
"key":"C1","x":7,"y":4,"s":1,"i":0},{
"key":"C1","x":7,"y":5,"s":1,"i":0},{
"key":"C1","x":7,"y":7,"s":1,"i":0},{
"key":"C1","x":7,"y":8,"s":1,"i":0},{
"key":"K","x":8,"y":2,"s":1,"i":0},{
"key":"K","x":8,"y":4,"s":1,"i":0},{
"key":"K","x":8,"y":6,"s":1,"i":0},{
"key":"K","x":8,"y":8,"s":1,"i":0},{
"key":"C1","x":9,"y":1,"s":1,"i":0},{
"key":"K","x":9,"y":2,"s":1,"i":0},{
"key":"C1","x":9,"y":4,"s":1,"i":0},{
"key":"K","x":9,"y":5,"s":1,"i":0},{
"key":"C1","x":9,"y":7,"s":1,"i":0},{
"key":"K","x":9,"y":8,"s":1,"i":0},{
"key":"K","x":10,"y":1,"s":1,"i":0},{
"key":"BJ","x":10,"y":2,"s":1,"i":0},{
"key":"C1","x":10,"y":3,"s":1,"i":0},{
"key":"E","x":10,"y":4,"s":1,"i":0},{
"key":"AJ","x":10,"y":5,"s":1,"i":0},{
"key":"C1","x":10,"y":6,"s":1,"i":0},{
"key":"C","x":10,"y":7,"s":1,"i":0},{
"key":"DJ","x":10,"y":8,"s":1,"i":0},{
"key":"C1","x":10,"y":9,"s":1,"i":0},{
"key":"C1","x":11,"y":1,"s":1,"i":0},{
"key":"E","x":11,"y":2,"s":1,"i":0},{
"key":"C1","x":11,"y":4,"s":1,"i":0},{
"key":"C","x":11,"y":5,"s":1,"i":0},{
"key":"C1","x":11,"y":7,"s":1,"i":0},{
"key":"K","x":11,"y":8,"s":1,"i":0},{
"key":"C","x":12,"y":2,"s":1,"i":0},{
"key":"H","x":12,"y":4,"s":1,"i":0},{
"key":"H","x":12,"y":5,"s":1,"i":0},{
"key":"H","x":12,"y":6,"s":1,"i":0},{
"key":"B","x":12,"y":8,"s":1,"i":0},{
"key":"E","x":13,"y":1,"s":1,"i":0},{
"key":"C","x":13,"y":2,"s":1,"i":0},{
"key":"D","x":13,"y":4,"s":1,"i":0},{
"key":"C","x":13,"y":5,"s":1,"i":0},{
"key":"B","x":13,"y":7,"s":1,"i":0},{
"key":"D","x":13,"y":8,"s":1,"i":0},{
"key":"E","x":14,"y":1,"s":1,"i":0},{
"key":"N","x":14,"y":2,"s":1,"i":0},{
"key":"B","x":14,"y":3,"s":1,"i":0},{
"key":"D","x":14,"y":4,"s":1,"i":0},{
"key":"A","x":14,"y":5,"s":1,"i":0},{
"key":"C","x":14,"y":6,"s":1,"i":0},{
"key":"E","x":14,"y":7,"s":1,"i":0},{
"key":"N","x":14,"y":8,"s":1,"i":0},{
"key":"D","x":14,"y":9,"s":1,"i":0},{
"key":"E","x":15,"y":1,"s":1,"i":0},{
"key":"B","x":15,"y":2,"s":1,"i":0},{
"key":"A","x":15,"y":4,"s":1,"i":0},{
"key":"B","x":15,"y":5,"s":1,"i":0},{
"key":"E","x":15,"y":7,"s":1,"i":0},{
"key":"A","x":15,"y":8,"s":1,"i":0},{
"key":"D","x":16,"y":2,"s":1,"i":0},{
"key":"E","x":16,"y":4,"s":1,"i":0},{
"key":"B","x":16,"y":6,"s":1,"i":0},{
"key":"A","x":16,"y":8,"s":1,"i":0},{
"key":"D","x":17,"y":1,"s":1,"i":0},{
"key":"C","x":17,"y":2,"s":1,"i":0},{
"key":"E","x":17,"y":4,"s":1,"i":0},{
"key":"C","x":17,"y":5,"s":1,"i":0},{
"key":"C","x":17,"y":7,"s":1,"i":0},{
"key":"C","x":17,"y":8,"s":1,"i":0},{
"key":"A","x":18,"y":1,"s":1,"i":0},{
"key":"A","x":18,"y":2,"s":1,"i":0},{
"key":"C","x":18,"y":3,"s":1,"i":0},{
"key":"A","x":18,"y":4,"s":1,"i":0},{
"key":"I","x":18,"y":5,"s":1,"i":0},{
"key":"D","x":18,"y":6,"s":1,"i":0},{
"key":"D","x":18,"y":7,"s":1,"i":0},{
"key":"C","x":18,"y":8,"s":1,"i":0},{
"key":"B","x":18,"y":9,"s":1,"i":0},{
"key":"E","x":19,"y":1,"s":1,"i":0},{
"key":"E","x":19,"y":2,"s":1,"i":0},{
"key":"A","x":19,"y":4,"s":1,"i":0},{
"key":"B","x":19,"y":5,"s":1,"i":0},{
"key":"E","x":19,"y":7,"s":1,"i":0},{
"key":"B","x":19,"y":8,"s":1,"i":0},{
"key":"C","x":20,"y":2,"s":1,"i":0},{
"key":"H","x":20,"y":4,"s":1,"i":0},{
"key":"H","x":20,"y":5,"s":1,"i":0},{
"key":"H","x":20,"y":6,"s":1,"i":0},{
"key":"E","x":20,"y":8,"s":1,"i":0},{
"key":"B","x":21,"y":1,"s":1,"i":0},{
"key":"E","x":21,"y":2,"s":1,"i":0},{
"key":"D","x":21,"y":4,"s":1,"i":0},{
"key":"D","x":21,"y":5,"s":1,"i":0},{
"key":"A","x":21,"y":7,"s":1,"i":0},{
"key":"D","x":21,"y":8,"s":1,"i":0},{
"key":"B","x":22,"y":1,"s":1,"i":0},{
"key":"C","x":22,"y":2,"s":1,"i":0},{
"key":"E","x":22,"y":3,"s":1,"i":0},{
"key":"B","x":22,"y":4,"s":1,"i":0},{
"key":"B","x":22,"y":5,"s":1,"i":0},{
"key":"C","x":22,"y":6,"s":1,"i":0},{
"key":"A","x":22,"y":7,"s":1,"i":0},{
"key":"B","x":22,"y":8,"s":1,"i":0},{
"key":"B","x":22,"y":9,"s":1,"i":0},{
"key":"A","x":23,"y":1,"s":1,"i":0},{
"key":"A","x":23,"y":2,"s":1,"i":0},{
"key":"D","x":23,"y":4,"s":1,"i":0},{
"key":"E","x":23,"y":5,"s":1,"i":0},{
"key":"C","x":23,"y":7,"s":1,"i":0},{
"key":"D","x":23,"y":8,"s":1,"i":0},{
"key":"B","x":24,"y":2,"s":1,"i":0},{
"key":"D","x":24,"y":4,"s":1,"i":0},{
"key":"E","x":24,"y":6,"s":1,"i":0},{
"key":"C","x":24,"y":8,"s":1,"i":0}],"sub
":[{
"key":"S","x":16,"y":2,"s":0,"i":0},{
"key":"S","x":16,"y":4,"s":0,"i":0},{
"key":"S","x":16,"y":6,"s":0,"i":0},{
"key":"S","x":16,"y":8,"s":0,"i":0},{
"key":"S","x":18,"y":1,"s":0,"i":0},{
"key":"S","x":18,"y":2,"s":0,"i":0},{
"key":"S","x":18,"y":3,"s":0,"i":0},{
"key":"S","x":18,"y":4,"s":0,"i":0},{
"key":"S","x":18,"y":6,"s":0,"i":0},{
"key":"S","x":18,"y":7,"s":0,"i":0},{
"key":"S","x":18,"y":8,"s":0,"i":0},{
"key":"S","x":18,"y":9,"s":0,"i":0},{
"key":"S","x":20,"y":2,"s":0,"i":0},{
"key":"S","x":20,"y":8,"s":0,"i":0},{
"key":"S","x":22,"y":1,"s":0,"i":0},{
"key":"S","x":22,"y":2,"s":0,"i":0},{
"key":"S","x":22,"y":3,"s":0,"i":0},{
"key":"S","x":22,"y":4,"s":0,"i":0},{
"key":"S","x":22,"y":5,"s":0,"i":0},{
"key":"S","x":22,"y":6,"s":0,"i":0},{
"key":"S","x":22,"y":7,"s":0,"i":0},{
"key":"S","x":22,"y":8,"s":0,"i":0},{
"key":"S","x":22,"y":9,"s":0,"i":0},{
"key":"S","x":24,"y":2,"s":0,"i":0},{
"key":"S","x":24,"y":4,"s":0,"i":0},{
"key":"S","x":24,"y":6,"s":0,"i":0},{
"key":"S","x":24,"y":8,"s":0,"i":0}]}