{
"BackCround":{
"backCround_type":1,"bottom_type":2,"skill_type":0},"level":589,"mode":1,"LevelType":{
"Key":"@","Type":1,"Number":2},"Star":{
"star1":120,"star2":35555,"star3":45555},"Gang":{
"Gang1":0,"Gang2":1,"Gang3":1,"Gang4":1,"Gang5":0},"ReadyBubble":{
"R1":0,"R2":0,"R3":0,"R4":0},"BallNumber":29,"TimeLimit":0,"ObjChance":[{
"Key":"C","P":4},{
"Key":"A","P":4},{
"Key":"B","P":4},{
"Key":"E","P":4}],"top":[],"bubble
":[{
"key":"C","x":0,"y":3,"s":1,"i":0},{
"key":"CJ","x":0,"y":4,"s":1,"i":0},{
"key":"C","x":0,"y":5,"s":1,"i":0},{
"key":"@","x":0,"y":6,"s":1,"i":0},{
"key":"@","x":0,"y":7,"s":1,"i":0},{
"key":"H","x":0,"y":8,"s":1,"i":0},{
"key":"H","x":1,"y":2,"s":1,"i":0},{
"key":"K","x":1,"y":3,"s":1,"i":0},{
"key":"H","x":1,"y":4,"s":1,"i":0},{
"key":"F","x":1,"y":5,"s":1,"i":0},{
"key":"F","x":1,"y":6,"s":1,"i":0},{
"key":"K","x":1,"y":7,"s":1,"i":0},{
"key":"A1","x":1,"y":8,"s":1,"i":0},{
"key":"C","x":2,"y":2,"s":1,"i":0},{
"key":"C","x":2,"y":3,"s":1,"i":0},{
"key":"A","x":2,"y":4,"s":1,"i":0},{
"key":"A","x":2,"y":5,"s":1,"i":0},{
"key":"@","x":2,"y":6,"s":1,"i":0},{
"key":"H","x":2,"y":7,"s":1,"i":0},{
"key":"A1","x":2,"y":8,"s":1,"i":0},{
"key":"AJ","x":2,"y":9,"s":1,"i":0},{
"key":"C1","x":3,"y":1,"s":1,"i":0},{
"key":"F","x":3,"y":2,"s":1,"i":0},{
"key":"F","x":3,"y":3,"s":1,"i":0},{
"key":"C1","x":3,"y":4,"s":1,"i":0},{
"key":"C1","x":3,"y":5,"s":1,"i":0},{
"key":"A1","x":3,"y":7,"s":1,"i":0},{
"key":"A1","x":3,"y":8,"s":1,"i":0},{
"key":"B","x":3,"y":9,"s":1,"i":0},{
"key":"H","x":4,"y":1,"s":1,"i":0},{
"key":"B","x":4,"y":2,"s":1,"i":0},{
"key":"B","x":4,"y":3,"s":1,"i":0},{
"key":"C1","x":4,"y":4,"s":1,"i":0},{
"key":"C1","x":4,"y":5,"s":1,"i":0},{
"key":"H","x":4,"y":7,"s":1,"i":0},{
"key":"K","x":4,"y":8,"s":1,"i":0},{
"key":"H","x":4,"y":9,"s":1,"i":0},{
"key":"B","x":4,"y":10,"s":1,"i":0},{
"key":"E","x":5,"y":0,"s":1,"i":0},{
"key":"K","x":5,"y":1,"s":1,"i":0},{
"key":"@","x":5,"y":2,"s":1,"i":0},{
"key":"A","x":5,"y":3,"s":1,"i":0},{
"key":"C","x":5,"y":7,"s":1,"i":0},{
"key":"C","x":5,"y":8,"s":1,"i":0},{
"key":"A1","x":5,"y":9,"s":1,"i":0},{
"key":"@","x":6,"y":0,"s":1,"i":0},{
"key":"E","x":6,"y":1,"s":1,"i":0},{
"key":"H","x":6,"y":2,"s":1,"i":0},{
"key":"B","x":6,"y":3,"s":1,"i":0},{
"key":"A","x":6,"y":4,"s":1,"i":0},{
"key":"F","x":6,"y":5,"s":1,"i":0},{
"key":"F","x":6,"y":6,"s":1,"i":0},{
"key":"E","x":6,"y":8,"s":1,"i":0},{
"key":"B","x":6,"y":9,"s":1,"i":0},{
"key":"A1","x":6,"y":10,"s":1,"i":0},{
"key":"A1","x":7,"y":0,"s":1,"i":0},{
"key":"F","x":7,"y":1,"s":1,"i":0},{
"key":"F","x":7,"y":2,"s":1,"i":0},{
"key":"A1","x":7,"y":3,"s":1,"i":0},{
"key":"A1","x":7,"y":4,"s":1,"i":0},{
"key":"A1","x":7,"y":5,"s":1,"i":0},{
"key":"A1","x":7,"y":6,"s":1,"i":0},{
"key":"A1","x":7,"y":7,"s":1,"i":0},{
"key":"A1","x":7,"y":8,"s":1,"i":0},{
"key":"A1","x":7,"y":9,"s":1,"i":0},{
"key":"A1","x":8,"y":0,"s":1,"i":0},{
"key":"A","x":8,"y":1,"s":1,"i":0},{
"key":"A","x":8,"y":2,"s":1,"i":0},{
"key":"A1","x":8,"y":3,"s":1,"i":0},{
"key":"C","x":8,"y":4,"s":1,"i":0},{
"key":"E","x":8,"y":5,"s":1,"i":0},{
"key":"B","x":8,"y":6,"s":1,"i":0},{
"key":"A","x":8,"y":7,"s":1,"i":0},{
"key":"B","x":8,"y":8,"s":1,"i":0},{
"key":"E","x":8,"y":9,"s":1,"i":0},{
"key":"@","x":8,"y":10,"s":1,"i":0},{
"key":"A1","x":9,"y":0,"s":1,"i":0},{
"key":"H","x":9,"y":1,"s":1,"i":0},{
"key":"K","x":9,"y":2,"s":1,"i":0},{
"key":"H","x":9,"y":3,"s":1,"i":0},{
"key":"C","x":9,"y":4,"s":1,"i":0},{
"key":"B","x":9,"y":5,"s":1,"i":0},{
"key":"H","x":9,"y":6,"s":1,"i":0},{
"key":"F","x":9,"y":7,"s":1,"i":0},{
"key":"F","x":9,"y":8,"s":1,"i":0},{
"key":"A","x":9,"y":9,"s":1,"i":0},{
"key":"F","x":10,"y":0,"s":1,"i":0},{
"key":"F","x":10,"y":1,"s":1,"i":0},{
"key":"E","x":10,"y":2,"s":1,"i":0},{
"key":"@","x":10,"y":3,"s":1,"i":0},{
"key":"C","x":10,"y":4,"s":1,"i":0},{
"key":"C","x":10,"y":5,"s":1,"i":0},{
"key":"E","x":10,"y":6,"s":1,"i":0},{
"key":"K","x":10,"y":7,"s":1,"i":0},{
"key":"C","x":10,"y":8,"s":1,"i":0},{
"key":"A","x":10,"y":9,"s":1,"i":0},{
"key":"A","x":10,"y":10,"s":1,"i":0},{
"key":"E","x":11,"y":0,"s":1,"i":0},{
"key":"E","x":11,"y":1,"s":1,"i":0},{
"key":"@","x":11,"y":2,"s":1,"i":0},{
"key":"F","x":11,"y":3,"s":1,"i":0},{
"key":"F","x":11,"y":4,"s":1,"i":0},{
"key":"@","x":11,"y":5,"s":1,"i":0},{
"key":"E","x":11,"y":6,"s":1,"i":0},{
"key":"H","x":11,"y":7,"s":1,"i":0},{
"key":"C","x":11,"y":8,"s":1,"i":0},{
"key":"A","x":11,"y":9,"s":1,"i":0},{
"key":"@","x":12,"y":0,"s":1,"i":0},{
"key":"A","x":12,"y":1,"s":1,"i":0},{
"key":"A","x":12,"y":2,"s":1,"i":0},{
"key":"@","x":12,"y":3,"s":1,"i":0},{
"key":"@","x":12,"y":4,"s":1,"i":0},{
"key":"@","x":12,"y":5,"s":1,"i":0},{
"key":"@","x":12,"y":6,"s":1,"i":0},{
"key":"F","x":12,"y":7,"s":1,"i":0},{
"key":"F","x":12,"y":8,"s":1,"i":0},{
"key":"@","x":13,"y":0,"s":1,"i":0},{
"key":"A","x":13,"y":2,"s":1,"i":0},{
"key":"@","x":13,"y":3,"s":1,"i":0},{
"key":"L","x":13,"y":4,"s":1,"i":0},{
"key":"@","x":13,"y":5,"s":1,"i":0},{
"key":"@","x":13,"y":6,"s":1,"i":0},{
"key":"A","x":13,"y":7,"s":1,"i":0},{
"key":"@","x":14,"y":0,"s":1,"i":0},{
"key":"H","x":14,"y":3,"s":1,"i":0},{
"key":"K","x":14,"y":4,"s":1,"i":0},{
"key":"H","x":14,"y":5,"s":1,"i":0},{
"key":"@","x":14,"y":6,"s":1,"i":0},{
"key":"@","x":14,"y":7,"s":1,"i":0},{
"key":"A","x":14,"y":8,"s":1,"i":0},{
"key":"@","x":15,"y":3,"s":1,"i":0},{
"key":"@","x":15,"y":4,"s":1,"i":0},{
"key":"F","x":15,"y":5,"s":1,"i":0},{
"key":"F","x":15,"y":6,"s":1,"i":0},{
"key":"E","x":15,"y":7,"s":1,"i":0},{
"key":"A","x":15,"y":8,"s":1,"i":0},{
"key":"@","x":15,"y":9,"s":1,"i":0},{
"key":"C","x":16,"y":4,"s":1,"i":0},{
"key":"C","x":16,"y":5,"s":1,"i":0},{
"key":"E","x":16,"y":6,"s":1,"i":0},{
"key":"E","x":16,"y":7,"s":1,"i":0},{
"key":"@","x":16,"y":8,"s":1,"i":0},{
"key":"K","x":16,"y":9,"s":1,"i":0},{
"key":"@","x":16,"y":10,"s":1,"i":0},{
"key":"@","x":17,"y":0,"s":1,"i":0},{
"key":"F","x":17,"y":1,"s":1,"i":0},{
"key":"F","x":17,"y":2,"s":1,"i":0},{
"key":"H","x":17,"y":3,"s":1,"i":0},{
"key":"@","x":17,"y":4,"s":1,"i":0},{
"key":"@","x":17,"y":5,"s":1,"i":0},{
"key":"H","x":17,"y":6,"s":1,"i":0},{
"key":"K","x":17,"y":7,"s":1,"i":0},{
"key":"H","x":17,"y":8,"s":1,"i":0},{
"key":"@","x":17,"y":9,"s":1,"i":0},{
"key":"@","x":18,"y":0,"s":1,"i":0},{
"key":"N","x":18,"y":1,"s":1,"i":0},{
"key":"@","x":18,"y":2,"s":1,"i":0},{
"key":"K","x":18,"y":3,"s":1,"i":0},{
"key":"A","x":18,"y":4,"s":1,"i":0},{
"key":"@","x":18,"y":5,"s":1,"i":0},{
"key":"B","x":18,"y":6,"s":1,"i":0},{
"key":"@","x":18,"y":7,"s":1,"i":0},{
"key":"E","x":18,"y":9,"s":1,"i":0},{
"key":"E","x":18,"y":10,"s":1,"i":0},{
"key":"@","x":19,"y":0,"s":1,"i":0},{
"key":"E","x":19,"y":1,"s":1,"i":0},{
"key":"H","x":19,"y":2,"s":1,"i":0},{
"key":"A","x":19,"y":3,"s":1,"i":0},{
"key":"E","x":19,"y":4,"s":1,"i":0},{
"key":"B","x":19,"y":5,"s":1,"i":0},{
"key":"F","x":19,"y":6,"s":1,"i":0},{
"key":"F","x":19,"y":7,"s":1,"i":0},{
"key":"@","x":19,"y":9,"s":1,"i":0},{
"key":"H","x":20,"y":0,"s":1,"i":0},{
"key":"@","x":20,"y":1,"s":1,"i":0},{
"key":"E","x":20,"y":2,"s":1,"i":0},{
"key":"F","x":20,"y":3,"s":1,"i":0},{
"key":"F","x":20,"y":4,"s":1,"i":0},{
"key":"E","x":20,"y":5,"s":1,"i":0},{
"key":"@","x":20,"y":6,"s":1,"i":0},{
"key":"C","x":20,"y":7,"s":1,"i":0},{
"key":"C","x":20,"y":8,"s":1,"i":0},{
"key":"@","x":20,"y":10,"s":1,"i":0},{
"key":"K","x":21,"y":0,"s":1,"i":0},{
"key":"A","x":21,"y":1,"s":1,"i":0},{
"key":"A","x":21,"y":2,"s":1,"i":0},{
"key":"E","x":21,"y":3,"s":1,"i":0},{
"key":"H","x":21,"y":4,"s":1,"i":0},{
"key":"K","x":21,"y":5,"s":1,"i":0},{
"key":"H","x":21,"y":6,"s":1,"i":0},{
"key":"B","x":21,"y":7,"s":1,"i":0},{
"key":"B","x":21,"y":8,"s":1,"i":0},{
"key":"H","x":22,"y":0,"s":1,"i":0},{
"key":"B","x":22,"y":1,"s":1,"i":0},{
"key":"F","x":22,"y":5,"s":1,"i":0},{
"key":"F","x":22,"y":6,"s":1,"i":0},{
"key":"A","x":22,"y":7,"s":1,"i":0},{
"key":"B","x":22,"y":8,"s":1,"i":0},{
"key":"H","x":22,"y":9,"s":1,"i":0},{
"key":"B","x":23,"y":0,"s":1,"i":0},{
"key":"C","x":23,"y":1,"s":1,"i":0},{
"key":"@","x":23,"y":4,"s":1,"i":0},{
"key":"@","x":23,"y":5,"s":1,"i":0},{
"key":"A","x":23,"y":6,"s":1,"i":0},{
"key":"@","x":23,"y":7,"s":1,"i":0},{
"key":"K","x":23,"y":8,"s":1,"i":0},{
"key":"E","x":23,"y":9,"s":1,"i":0},{
"key":"@","x":24,"y":0,"s":1,"i":0},{
"key":"C","x":24,"y":1,"s":1,"i":0},{
"key":"C","x":24,"y":2,"s":1,"i":0},{
"key":"H","x":24,"y":4,"s":1,"i":0},{
"key":"K","x":24,"y":5,"s":1,"i":0},{
"key":"A","x":24,"y":6,"s":1,"i":0},{
"key":"A","x":24,"y":7,"s":1,"i":0},{
"key":"E","x":24,"y":8,"s":1,"i":0},{
"key":"E","x":24,"y":9,"s":1,"i":0},{
"key":"E","x":24,"y":10,"s":1,"i":0}],"sub
":[]}