{
"BackCround":{
"backCround_type":1,"bottom_type":2,"skill_type":0},"level":958,"mode":1,"LevelType":{
"Key":"@","Type":1,"Number":18},"Star":{
"star1":100,"star2":10000,"star3":50000},"Gang":{
"Gang1":0,"Gang2":0,"Gang3":0,"Gang4":0,"Gang5":1},"ReadyBubble":{
"R1":0,"R2":0,"R3":0,"R4":0},"BallNumber":18,"TimeLimit":0,"ObjChance":[{
"Key":"C","P":1},{
"Key":"A","P":1},{
"Key":"B","P":1},{
"Key":"E","P":1},{
"Key":"D","P":1}],"top":[],"bubble
":[{
"key":"A1","x":0,"y":3,"s":1,"i":0},{
"key":"C1","x":0,"y":4,"s":1,"i":0},{
"key":"C1","x":0,"y":5,"s":1,"i":0},{
"key":"C1","x":0,"y":6,"s":1,"i":0},{
"key":"A1","x":0,"y":7,"s":1,"i":0},{
"key":"C1","x":1,"y":2,"s":1,"i":0},{
"key":"CJ","x":1,"y":3,"s":1,"i":0},{
"key":"AJ","x":1,"y":6,"s":1,"i":0},{
"key":"C1","x":1,"y":7,"s":1,"i":0},{
"key":"C1","x":2,"y":2,"s":1,"i":0},{
"key":"A1","x":2,"y":4,"s":1,"i":0},{
"key":"A1","x":2,"y":5,"s":1,"i":0},{
"key":"A1","x":2,"y":6,"s":1,"i":0},{
"key":"C1","x":2,"y":8,"s":1,"i":0},{
"key":"C1","x":3,"y":1,"s":1,"i":0},{
"key":"AJ","x":3,"y":2,"s":1,"i":0},{
"key":"A1","x":3,"y":3,"s":1,"i":0},{
"key":"A1","x":3,"y":6,"s":1,"i":0},{
"key":"BJ","x":3,"y":7,"s":1,"i":0},{
"key":"C1","x":3,"y":8,"s":1,"i":0},{
"key":"C1","x":4,"y":1,"s":1,"i":0},{
"key":"A1","x":4,"y":3,"s":1,"i":0},{
"key":"BJ","x":4,"y":4,"s":1,"i":0},{
"key":"A1","x":4,"y":5,"s":1,"i":0},{
"key":"EJ","x":4,"y":6,"s":1,"i":0},{
"key":"A1","x":4,"y":7,"s":1,"i":0},{
"key":"C1","x":4,"y":9,"s":1,"i":0},{
"key":"C1","x":5,"y":0,"s":1,"i":0},{
"key":"CJ","x":5,"y":1,"s":1,"i":0},{
"key":"A1","x":5,"y":2,"s":1,"i":0},{
"key":"A1","x":5,"y":4,"s":1,"i":0},{
"key":"A1","x":5,"y":5,"s":1,"i":0},{
"key":"A1","x":5,"y":7,"s":1,"i":0},{
"key":"EJ","x":5,"y":8,"s":1,"i":0},{
"key":"C1","x":5,"y":9,"s":1,"i":0},{
"key":"C1","x":6,"y":0,"s":1,"i":0},{
"key":"A1","x":6,"y":2,"s":1,"i":0},{
"key":"BJ","x":6,"y":3,"s":1,"i":0},{
"key":"A1","x":6,"y":4,"s":1,"i":0},{
"key":"A1","x":6,"y":6,"s":1,"i":0},{
"key":"DJ","x":6,"y":7,"s":1,"i":0},{
"key":"A1","x":6,"y":8,"s":1,"i":0},{
"key":"C1","x":6,"y":10,"s":1,"i":0},{
"key":"C1","x":7,"y":0,"s":1,"i":0},{
"key":"DJ","x":7,"y":1,"s":1,"i":0},{
"key":"A1","x":7,"y":2,"s":1,"i":0},{
"key":"A1","x":7,"y":4,"s":1,"i":0},{
"key":"A1","x":7,"y":5,"s":1,"i":0},{
"key":"A1","x":7,"y":7,"s":1,"i":0},{
"key":"DJ","x":7,"y":8,"s":1,"i":0},{
"key":"C1","x":7,"y":9,"s":1,"i":0},{
"key":"C1","x":8,"y":1,"s":1,"i":0},{
"key":"A1","x":8,"y":3,"s":1,"i":0},{
"key":"AJ","x":8,"y":4,"s":1,"i":0},{
"key":"A1","x":8,"y":5,"s":1,"i":0},{
"key":"CJ","x":8,"y":6,"s":1,"i":0},{
"key":"A1","x":8,"y":7,"s":1,"i":0},{
"key":"C1","x":8,"y":9,"s":1,"i":0},{
"key":"C1","x":9,"y":1,"s":1,"i":0},{
"key":"EJ","x":9,"y":2,"s":1,"i":0},{
"key":"A1","x":9,"y":3,"s":1,"i":0},{
"key":"A1","x":9,"y":6,"s":1,"i":0},{
"key":"CJ","x":9,"y":7,"s":1,"i":0},{
"key":"C1","x":9,"y":8,"s":1,"i":0},{
"key":"C1","x":10,"y":2,"s":1,"i":0},{
"key":"A1","x":10,"y":4,"s":1,"i":0},{
"key":"A1","x":10,"y":5,"s":1,"i":0},{
"key":"A1","x":10,"y":6,"s":1,"i":0},{
"key":"C1","x":10,"y":8,"s":1,"i":0},{
"key":"C1","x":11,"y":2,"s":1,"i":0},{
"key":"BJ","x":11,"y":3,"s":1,"i":0},{
"key":"AJ","x":11,"y":6,"s":1,"i":0},{
"key":"C1","x":11,"y":7,"s":1,"i":0},{
"key":"A1","x":12,"y":3,"s":1,"i":0},{
"key":"C1","x":12,"y":4,"s":1,"i":0},{
"key":"C1","x":12,"y":5,"s":1,"i":0},{
"key":"C1","x":12,"y":6,"s":1,"i":0},{
"key":"A1","x":12,"y":7,"s":1,"i":0},{
"key":"C","x":13,"y":0,"s":1,"i":0},{
"key":"C","x":13,"y":1,"s":1,"i":0},{
"key":"C","x":13,"y":2,"s":1,"i":0},{
"key":"C","x":13,"y":7,"s":1,"i":0},{
"key":"C","x":13,"y":8,"s":1,"i":0},{
"key":"C","x":13,"y":9,"s":1,"i":0},{
"key":"C","x":14,"y":3,"s":1,"i":0},{
"key":"C","x":14,"y":4,"s":1,"i":0},{
"key":"C","x":14,"y":5,"s":1,"i":0},{
"key":"C","x":14,"y":6,"s":1,"i":0},{
"key":"C","x":14,"y":7,"s":1,"i":0}],"sub
":[],"down
":[]}