{
"BackCround":{
"backCround_type":1,"bottom_type":2,"skill_type":0},"level":734,"mode":1,"LevelType":{
"Key":"@","Type":1,"Number":10},"Star":{
"star1":120,"star2":35670,"star3":91130},"Gang":{
"Gang1":0,"Gang2":1,"Gang3":0,"Gang4":0,"Gang5":1},"ReadyBubble":{
"R1":0,"R2":0,"R3":0,"R4":0},"BallNumber":21,"TimeLimit":0,"ObjChance":[{
"Key":"C","P":5},{
"Key":"A","P":5},{
"Key":"B","P":5},{
"Key":"D","P":5}],"top":[],"bubble
":[{
"key":"I","x":0,"y":0,"s":1,"i":0},{
"key":"I","x":0,"y":1,"s":1,"i":0},{
"key":"I","x":0,"y":2,"s":1,"i":0},{
"key":"AC","x":0,"y":5,"s":1,"i":0},{
"key":"I","x":0,"y":8,"s":1,"i":0},{
"key":"CJ","x":0,"y":9,"s":1,"i":0},{
"key":"AJ","x":0,"y":10,"s":1,"i":0},{
"key":"D1","x":1,"y":0,"s":1,"i":0},{
"key":"D1","x":1,"y":1,"s":1,"i":0},{
"key":"I","x":1,"y":2,"s":1,"i":0},{
"key":"C1","x":1,"y":4,"s":1,"i":0},{
"key":"C1","x":1,"y":5,"s":1,"i":0},{
"key":"I","x":1,"y":7,"s":1,"i":0},{
"key":"CJ","x":1,"y":8,"s":1,"i":0},{
"key":"AJ","x":1,"y":9,"s":1,"i":0},{
"key":"M","x":2,"y":0,"s":1,"i":0},{
"key":"I","x":2,"y":3,"s":1,"i":0},{
"key":"C1","x":2,"y":4,"s":1,"i":0},{
"key":"C1","x":2,"y":5,"s":1,"i":0},{
"key":"C1","x":2,"y":6,"s":1,"i":0},{
"key":"I","x":2,"y":7,"s":1,"i":0},{
"key":"CJ","x":2,"y":8,"s":1,"i":0},{
"key":"AJ","x":2,"y":9,"s":1,"i":0},{
"key":"L","x":2,"y":10,"s":1,"i":0},{
"key":"F","x":3,"y":2,"s":1,"i":0},{
"key":"I","x":3,"y":3,"s":1,"i":0},{
"key":"J","x":3,"y":4,"s":1,"i":0},{
"key":"J","x":3,"y":5,"s":1,"i":0},{
"key":"I","x":3,"y":6,"s":1,"i":0},{
"key":"I","x":3,"y":7,"s":1,"i":0},{
"key":"CJ","x":3,"y":8,"s":1,"i":0},{
"key":"AJ","x":3,"y":9,"s":1,"i":0},{
"key":"F","x":4,"y":0,"s":1,"i":0},{
"key":"F","x":4,"y":1,"s":1,"i":0},{
"key":"F","x":4,"y":2,"s":1,"i":0},{
"key":"I","x":4,"y":3,"s":1,"i":0},{
"key":"D1","x":4,"y":4,"s":1,"i":0},{
"key":"AD","x":4,"y":5,"s":1,"i":0},{
"key":"D1","x":4,"y":6,"s":1,"i":0},{
"key":"I","x":4,"y":7,"s":1,"i":0},{
"key":"I","x":4,"y":8,"s":1,"i":0},{
"key":"CJ","x":4,"y":9,"s":1,"i":0},{
"key":"AJ","x":4,"y":10,"s":1,"i":0},{
"key":"AA","x":5,"y":0,"s":1,"i":0},{
"key":"AA","x":5,"y":1,"s":1,"i":0},{
"key":"I","x":5,"y":2,"s":1,"i":0},{
"key":"D1","x":5,"y":4,"s":1,"i":0},{
"key":"D1","x":5,"y":5,"s":1,"i":0},{
"key":"I","x":5,"y":7,"s":1,"i":0},{
"key":"I","x":5,"y":8,"s":1,"i":0},{
"key":"I","x":5,"y":9,"s":1,"i":0},{
"key":"A","x":6,"y":2,"s":1,"i":0},{
"key":"A","x":6,"y":3,"s":1,"i":0},{
"key":"D1","x":6,"y":5,"s":1,"i":0},{
"key":"A","x":6,"y":7,"s":1,"i":0},{
"key":"A","x":6,"y":8,"s":1,"i":0},{
"key":"B","x":7,"y":1,"s":1,"i":0},{
"key":"B","x":7,"y":2,"s":1,"i":0},{
"key":"B","x":7,"y":3,"s":1,"i":0},{
"key":"A","x":7,"y":4,"s":1,"i":0},{
"key":"A","x":7,"y":5,"s":1,"i":0},{
"key":"B","x":7,"y":6,"s":1,"i":0},{
"key":"B","x":7,"y":7,"s":1,"i":0},{
"key":"B","x":7,"y":8,"s":1,"i":0},{
"key":"D","x":8,"y":1,"s":1,"i":0},{
"key":"A","x":8,"y":2,"s":1,"i":0},{
"key":"C","x":8,"y":3,"s":1,"i":0},{
"key":"C","x":8,"y":4,"s":1,"i":0},{
"key":"A","x":8,"y":5,"s":1,"i":0},{
"key":"C","x":8,"y":6,"s":1,"i":0},{
"key":"C","x":8,"y":7,"s":1,"i":0},{
"key":"A","x":8,"y":8,"s":1,"i":0},{
"key":"D","x":8,"y":9,"s":1,"i":0},{
"key":"A","x":9,"y":0,"s":1,"i":0},{
"key":"D","x":9,"y":1,"s":1,"i":0},{
"key":"A","x":9,"y":2,"s":1,"i":0},{
"key":"JB","x":9,"y":3,"s":1,"i":0},{
"key":"JB","x":9,"y":4,"s":1,"i":0},{
"key":"JB","x":9,"y":5,"s":1,"i":0},{
"key":"JB","x":9,"y":6,"s":1,"i":0},{
"key":"A","x":9,"y":7,"s":1,"i":0},{
"key":"D","x":9,"y":8,"s":1,"i":0},{
"key":"A","x":9,"y":9,"s":1,"i":0},{
"key":"O","x":10,"y":0,"s":1,"i":0},{
"key":"A","x":10,"y":1,"s":1,"i":0},{
"key":"D","x":10,"y":2,"s":1,"i":0},{
"key":"A","x":10,"y":3,"s":1,"i":0},{
"key":"A","x":10,"y":4,"s":1,"i":0},{
"key":"C","x":10,"y":5,"s":1,"i":0},{
"key":"A","x":10,"y":6,"s":1,"i":0},{
"key":"A","x":10,"y":7,"s":1,"i":0},{
"key":"D","x":10,"y":8,"s":1,"i":0},{
"key":"A","x":10,"y":9,"s":1,"i":0},{
"key":"M","x":10,"y":10,"s":1,"i":0},{
"key":"A","x":11,"y":0,"s":1,"i":0},{
"key":"C","x":11,"y":1,"s":1,"i":0},{
"key":"D","x":11,"y":2,"s":1,"i":0},{
"key":"A","x":11,"y":3,"s":1,"i":0},{
"key":"C","x":11,"y":4,"s":1,"i":0},{
"key":"C","x":11,"y":5,"s":1,"i":0},{
"key":"A","x":11,"y":6,"s":1,"i":0},{
"key":"D","x":11,"y":7,"s":1,"i":0},{
"key":"C","x":11,"y":8,"s":1,"i":0},{
"key":"A","x":11,"y":9,"s":1,"i":0},{
"key":"A","x":12,"y":0,"s":1,"i":0},{
"key":"D","x":12,"y":1,"s":1,"i":0},{
"key":"C","x":12,"y":2,"s":1,"i":0},{
"key":"C","x":12,"y":3,"s":1,"i":0},{
"key":"B","x":12,"y":4,"s":1,"i":0},{
"key":"D","x":12,"y":5,"s":1,"i":0},{
"key":"D","x":12,"y":6,"s":1,"i":0},{
"key":"C","x":12,"y":7,"s":1,"i":0},{
"key":"C","x":12,"y":8,"s":1,"i":0},{
"key":"D","x":12,"y":9,"s":1,"i":0},{
"key":"A","x":12,"y":10,"s":1,"i":0},{
"key":"D","x":13,"y":1,"s":1,"i":0},{
"key":"A","x":13,"y":2,"s":1,"i":0},{
"key":"B","x":13,"y":3,"s":1,"i":0},{
"key":"B","x":13,"y":4,"s":1,"i":0},{
"key":"D","x":13,"y":5,"s":1,"i":0},{
"key":"A","x":13,"y":6,"s":1,"i":0},{
"key":"A","x":13,"y":7,"s":1,"i":0},{
"key":"D","x":13,"y":8,"s":1,"i":0},{
"key":"H","x":14,"y":1,"s":1,"i":0},{
"key":"A","x":14,"y":2,"s":1,"i":0},{
"key":"C","x":14,"y":3,"s":1,"i":0},{
"key":"C","x":14,"y":4,"s":1,"i":0},{
"key":"@","x":14,"y":5,"s":1,"i":0},{
"key":"C","x":14,"y":6,"s":1,"i":0},{
"key":"C","x":14,"y":7,"s":1,"i":0},{
"key":"A","x":14,"y":8,"s":1,"i":0},{
"key":"H","x":14,"y":9,"s":1,"i":0},{
"key":"H","x":15,"y":0,"s":1,"i":0},{
"key":"@","x":15,"y":2,"s":1,"i":0},{
"key":"AA","x":15,"y":3,"s":1,"i":0},{
"key":"AA","x":15,"y":4,"s":1,"i":0},{
"key":"AA","x":15,"y":5,"s":1,"i":0},{
"key":"AA","x":15,"y":6,"s":1,"i":0},{
"key":"@","x":15,"y":7,"s":1,"i":0},{
"key":"H","x":15,"y":9,"s":1,"i":0},{
"key":"H","x":16,"y":0,"s":1,"i":0},{
"key":"@","x":16,"y":3,"s":1,"i":0},{
"key":"@","x":16,"y":4,"s":1,"i":0},{
"key":"D","x":16,"y":5,"s":1,"i":0},{
"key":"@","x":16,"y":6,"s":1,"i":0},{
"key":"@","x":16,"y":7,"s":1,"i":0},{
"key":"H","x":16,"y":10,"s":1,"i":0},{
"key":"B","x":17,"y":3,"s":1,"i":0},{
"key":"D","x":17,"y":4,"s":1,"i":0},{
"key":"D","x":17,"y":5,"s":1,"i":0},{
"key":"C","x":17,"y":6,"s":1,"i":0},{
"key":"B","x":18,"y":4,"s":1,"i":0},{
"key":"@","x":18,"y":5,"s":1,"i":0},{
"key":"C","x":18,"y":6,"s":1,"i":0},{
"key":"C","x":19,"y":0,"s":1,"i":0},{
"key":"B","x":19,"y":1,"s":1,"i":0},{
"key":"B","x":19,"y":2,"s":1,"i":0},{
"key":"D","x":19,"y":4,"s":1,"i":0},{
"key":"D","x":19,"y":5,"s":1,"i":0},{
"key":"B","x":19,"y":7,"s":1,"i":0},{
"key":"A","x":19,"y":8,"s":1,"i":0},{
"key":"B","x":19,"y":9,"s":1,"i":0},{
"key":"M","x":20,"y":0,"s":1,"i":0},{
"key":"D","x":20,"y":1,"s":1,"i":0},{
"key":"N","x":20,"y":2,"s":1,"i":0},{
"key":"B","x":20,"y":3,"s":1,"i":0},{
"key":"A","x":20,"y":4,"s":1,"i":0},{
"key":"N","x":20,"y":5,"s":1,"i":0},{
"key":"A","x":20,"y":6,"s":1,"i":0},{
"key":"B","x":20,"y":7,"s":1,"i":0},{
"key":"N","x":20,"y":8,"s":1,"i":0},{
"key":"A","x":20,"y":9,"s":1,"i":0},{
"key":"B","x":20,"y":10,"s":1,"i":0},{
"key":"D","x":21,"y":0,"s":1,"i":0},{
"key":"A","x":21,"y":1,"s":1,"i":0},{
"key":"@","x":21,"y":2,"s":1,"i":0},{
"key":"A","x":21,"y":4,"s":1,"i":0},{
"key":"@","x":21,"y":5,"s":1,"i":0},{
"key":"A","x":21,"y":7,"s":1,"i":0},{
"key":"@","x":21,"y":8,"s":1,"i":0},{
"key":"D","x":21,"y":9,"s":1,"i":0},{
"key":"C","x":22,"y":1,"s":1,"i":0},{
"key":"C","x":22,"y":2,"s":1,"i":0},{
"key":"C","x":22,"y":3,"s":1,"i":0},{
"key":"B","x":22,"y":7,"s":1,"i":0},{
"key":"B","x":22,"y":8,"s":1,"i":0},{
"key":"D","x":22,"y":9,"s":1,"i":0},{
"key":"A","x":23,"y":2,"s":1,"i":0},{
"key":"A","x":23,"y":4,"s":1,"i":0},{
"key":"A","x":23,"y":5,"s":1,"i":0},{
"key":"B","x":23,"y":7,"s":1,"i":0},{
"key":"A","x":24,"y":2,"s":1,"i":0},{
"key":"@","x":24,"y":3,"s":1,"i":0},{
"key":"@","x":24,"y":4,"s":1,"i":0},{
"key":"@","x":24,"y":5,"s":1,"i":0},{
"key":"@","x":24,"y":6,"s":1,"i":0},{
"key":"@","x":24,"y":7,"s":1,"i":0},{
"key":"C","x":24,"y":8,"s":1,"i":0},{
"key":"C","x":25,"y":1,"s":1,"i":0},{
"key":"C","x":25,"y":2,"s":1,"i":0},{
"key":"@","x":25,"y":3,"s":1,"i":0},{
"key":"@","x":25,"y":6,"s":1,"i":0},{
"key":"A","x":25,"y":7,"s":1,"i":0},{
"key":"C","x":25,"y":8,"s":1,"i":0},{
"key":"A","x":26,"y":1,"s":1,"i":0},{
"key":"@","x":26,"y":4,"s":1,"i":0},{
"key":"@","x":26,"y":5,"s":1,"i":0},{
"key":"@","x":26,"y":6,"s":1,"i":0},{
"key":"C","x":26,"y":9,"s":1,"i":0},{
"key":"A","x":27,"y":0,"s":1,"i":0},{
"key":"B","x":27,"y":1,"s":1,"i":0},{
"key":"B","x":27,"y":2,"s":1,"i":0},{
"key":"@","x":27,"y":4,"s":1,"i":0},{
"key":"@","x":27,"y":5,"s":1,"i":0},{
"key":"B","x":27,"y":7,"s":1,"i":0},{
"key":"B","x":27,"y":8,"s":1,"i":0},{
"key":"B","x":27,"y":9,"s":1,"i":0},{
"key":"@","x":28,"y":4,"s":1,"i":0},{
"key":"@","x":28,"y":5,"s":1,"i":0},{
"key":"@","x":28,"y":6,"s":1,"i":0},{
"key":"D","x":29,"y":1,"s":1,"i":0},{
"key":"D","x":29,"y":2,"s":1,"i":0},{
"key":"@","x":29,"y":4,"s":1,"i":0},{
"key":"@","x":29,"y":5,"s":1,"i":0},{
"key":"C","x":29,"y":7,"s":1,"i":0},{
"key":"C","x":29,"y":8,"s":1,"i":0},{
"key":"D","x":30,"y":1,"s":1,"i":0},{
"key":"@","x":30,"y":3,"s":1,"i":0},{
"key":"@","x":30,"y":4,"s":1,"i":0},{
"key":"@","x":30,"y":5,"s":1,"i":0},{
"key":"@","x":30,"y":6,"s":1,"i":0},{
"key":"@","x":30,"y":7,"s":1,"i":0},{
"key":"B","x":30,"y":9,"s":1,"i":0},{
"key":"C","x":31,"y":1,"s":1,"i":0},{
"key":"C","x":31,"y":2,"s":1,"i":0},{
"key":"@","x":31,"y":4,"s":1,"i":0},{
"key":"@","x":31,"y":5,"s":1,"i":0},{
"key":"A","x":31,"y":7,"s":1,"i":0},{
"key":"B","x":31,"y":8,"s":1,"i":0},{
"key":"D","x":32,"y":1,"s":1,"i":0},{
"key":"D","x":32,"y":3,"s":1,"i":0},{
"key":"@","x":32,"y":4,"s":1,"i":0},{
"key":"@","x":32,"y":6,"s":1,"i":0},{
"key":"A","x":32,"y":7,"s":1,"i":0},{
"key":"D","x":32,"y":9,"s":1,"i":0},{
"key":"A","x":33,"y":0,"s":1,"i":0},{
"key":"D","x":33,"y":1,"s":1,"i":0},{
"key":"D","x":33,"y":2,"s":1,"i":0},{
"key":"@","x":33,"y":4,"s":1,"i":0},{
"key":"@","x":33,"y":5,"s":1,"i":0},{
"key":"D","x":33,"y":7,"s":1,"i":0},{
"key":"D","x":33,"y":8,"s":1,"i":0},{
"key":"A","x":33,"y":9,"s":1,"i":0},{
"key":"A","x":34,"y":1,"s":1,"i":0},{
"key":"A","x":34,"y":2,"s":1,"i":0},{
"key":"@","x":34,"y":4,"s":1,"i":0},{
"key":"@","x":34,"y":5,"s":1,"i":0},{
"key":"@","x":34,"y":6,"s":1,"i":0},{
"key":"A","x":34,"y":8,"s":1,"i":0},{
"key":"A","x":34,"y":9,"s":1,"i":0},{
"key":"@","x":35,"y":4,"s":1,"i":0},{
"key":"@","x":35,"y":5,"s":1,"i":0},{
"key":"A","x":36,"y":5,"s":1,"i":0}],"sub
":[{
"key":"Suo","x":10,"y":9,"s":0,"i":0},{
"key":"Suo","x":12,"y":10,"s":0,"i":0},{
"key":"L","x":19,"y":0,"s":0,"i":0},{
"key":"L","x":19,"y":1,"s":0,"i":0},{
"key":"Suo","x":19,"y":2,"s":0,"i":0},{
"key":"Suo","x":19,"y":4,"s":0,"i":0},{
"key":"L","x":19,"y":5,"s":0,"i":0},{
"key":"L","x":19,"y":7,"s":0,"i":0},{
"key":"Suo","x":19,"y":8,"s":0,"i":0},{
"key":"L","x":19,"y":9,"s":0,"i":0},{
"key":"L","x":20,"y":3,"s":0,"i":0},{
"key":"Suo","x":20,"y":4,"s":0,"i":0},{
"key":"Suo","x":20,"y":6,"s":0,"i":0},{
"key":"L","x":20,"y":7,"s":0,"i":0},{
"key":"Suo","x":20,"y":9,"s":0,"i":0},{
"key":"L","x":20,"y":10,"s":0,"i":0},{
"key":"L","x":21,"y":0,"s":0,"i":0},{
"key":"L","x":21,"y":1,"s":0,"i":0},{
"key":"Suo","x":21,"y":2,"s":0,"i":0},{
"key":"L","x":21,"y":4,"s":0,"i":0},{
"key":"Suo","x":21,"y":5,"s":0,"i":0},{
"key":"L","x":21,"y":7,"s":0,"i":0},{
"key":"Suo","x":21,"y":8,"s":0,"i":0},{
"key":"L","x":21,"y":9,"s":0,"i":0},{
"key":"S","x":24,"y":3,"s":0,"i":0},{
"key":"S","x":24,"y":4,"s":0,"i":0},{
"key":"S","x":24,"y":5,"s":0,"i":0},{
"key":"S","x":24,"y":6,"s":0,"i":0},{
"key":"S","x":24,"y":7,"s":0,"i":0},{
"key":"S","x":25,"y":3,"s":0,"i":0},{
"key":"S","x":25,"y":6,"s":0,"i":0},{
"key":"S","x":26,"y":4,"s":0,"i":0},{
"key":"S","x":26,"y":5,"s":0,"i":0},{
"key":"S","x":26,"y":6,"s":0,"i":0},{
"key":"S","x":27,"y":4,"s":0,"i":0},{
"key":"S","x":27,"y":5,"s":0,"i":0},{
"key":"S","x":28,"y":4,"s":0,"i":0},{
"key":"S","x":28,"y":5,"s":0,"i":0},{
"key":"S","x":28,"y":6,"s":0,"i":0},{
"key":"S","x":29,"y":4,"s":0,"i":0},{
"key":"S","x":29,"y":5,"s":0,"i":0},{
"key":"S","x":30,"y":3,"s":0,"i":0},{
"key":"S","x":30,"y":4,"s":0,"i":0},{
"key":"S","x":30,"y":5,"s":0,"i":0},{
"key":"S","x":30,"y":6,"s":0,"i":0},{
"key":"S","x":30,"y":7,"s":0,"i":0},{
"key":"S","x":31,"y":4,"s":0,"i":0},{
"key":"S","x":31,"y":5,"s":0,"i":0},{
"key":"S","x":32,"y":4,"s":0,"i":0},{
"key":"S","x":32,"y":6,"s":0,"i":0},{
"key":"S","x":33,"y":4,"s":0,"i":0},{
"key":"S","x":33,"y":5,"s":0,"i":0},{
"key":"S","x":34,"y":4,"s":0,"i":0},{
"key":"S","x":34,"y":5,"s":0,"i":0},{
"key":"S","x":34,"y":6,"s":0,"i":0},{
"key":"S","x":35,"y":4,"s":0,"i":0},{
"key":"S","x":35,"y":5,"s":0,"i":0}]}