{
"BackCround":{
"backCround_type":1,"bottom_type":2,"skill_type":0},"level":676,"mode":1,"LevelType":{
"Key":"@","Type":1,"Number":6},"Star":{
"star1":120,"star2":22222,"star3":26000},"Gang":{
"Gang1":0,"Gang2":1,"Gang3":1,"Gang4":0,"Gang5":1},"ReadyBubble":{
"R1":0,"R2":0,"R3":0,"R4":0},"BallNumber":28,"TimeLimit":0,"ObjChance":[{
"Key":"C","P":4},{
"Key":"A","P":4},{
"Key":"B","P":4}],"top":[],"bubble
":[{
"key":"JA","x":0,"y":2,"s":1,"i":0},{
"key":"A1","x":0,"y":3,"s":1,"i":0},{
"key":"JB","x":0,"y":4,"s":1,"i":0},{
"key":"A1","x":1,"y":1,"s":1,"i":0},{
"key":"J","x":1,"y":2,"s":1,"i":0},{
"key":"J","x":1,"y":3,"s":1,"i":0},{
"key":"A1","x":1,"y":4,"s":1,"i":0},{
"key":"AJ","x":2,"y":1,"s":1,"i":0},{
"key":"J","x":2,"y":2,"s":1,"i":0},{
"key":"@","x":2,"y":3,"s":1,"i":0},{
"key":"J","x":2,"y":4,"s":1,"i":0},{
"key":"BJ","x":2,"y":5,"s":1,"i":0},{
"key":"I","x":2,"y":6,"s":1,"i":0},{
"key":"I","x":2,"y":7,"s":1,"i":0},{
"key":"I","x":2,"y":8,"s":1,"i":0},{
"key":"I","x":2,"y":9,"s":1,"i":0},{
"key":"I","x":2,"y":10,"s":1,"i":0},{
"key":"A1","x":3,"y":1,"s":1,"i":0},{
"key":"J","x":3,"y":2,"s":1,"i":0},{
"key":"J","x":3,"y":3,"s":1,"i":0},{
"key":"A1","x":3,"y":4,"s":1,"i":0},{
"key":"I","x":3,"y":9,"s":1,"i":0},{
"key":"JC","x":4,"y":2,"s":1,"i":0},{
"key":"A1","x":4,"y":3,"s":1,"i":0},{
"key":"CJ","x":4,"y":4,"s":1,"i":0},{
"key":"I","x":4,"y":5,"s":1,"i":0},{
"key":"B","x":4,"y":6,"s":1,"i":0},{
"key":"F","x":4,"y":7,"s":1,"i":0},{
"key":"BJ","x":4,"y":8,"s":1,"i":0},{
"key":"I","x":4,"y":9,"s":1,"i":0},{
"key":"B","x":5,"y":5,"s":1,"i":0},{
"key":"A","x":5,"y":6,"s":1,"i":0},{
"key":"F","x":5,"y":7,"s":1,"i":0},{
"key":"F","x":5,"y":8,"s":1,"i":0},{
"key":"I","x":6,"y":0,"s":1,"i":0},{
"key":"I","x":6,"y":1,"s":1,"i":0},{
"key":"I","x":6,"y":2,"s":1,"i":0},{
"key":"I","x":6,"y":3,"s":1,"i":0},{
"key":"I","x":6,"y":4,"s":1,"i":0},{
"key":"N","x":6,"y":5,"s":1,"i":0},{
"key":"C","x":6,"y":6,"s":1,"i":0},{
"key":"C","x":6,"y":7,"s":1,"i":0},{
"key":"F","x":6,"y":8,"s":1,"i":0},{
"key":"CJ","x":6,"y":9,"s":1,"i":0},{
"key":"I","x":7,"y":0,"s":1,"i":0},{
"key":"A","x":7,"y":5,"s":1,"i":0},{
"key":"B","x":7,"y":6,"s":1,"i":0},{
"key":"F","x":7,"y":7,"s":1,"i":0},{
"key":"F","x":7,"y":8,"s":1,"i":0},{
"key":"I","x":8,"y":1,"s":1,"i":0},{
"key":"C","x":8,"y":2,"s":1,"i":0},{
"key":"C","x":8,"y":3,"s":1,"i":0},{
"key":"F","x":8,"y":4,"s":1,"i":0},{
"key":"I","x":8,"y":5,"s":1,"i":0},{
"key":"A","x":8,"y":6,"s":1,"i":0},{
"key":"F","x":8,"y":7,"s":1,"i":0},{
"key":"AJ","x":8,"y":8,"s":1,"i":0},{
"key":"C","x":9,"y":1,"s":1,"i":0},{
"key":"F","x":9,"y":2,"s":1,"i":0},{
"key":"F","x":9,"y":3,"s":1,"i":0},{
"key":"B","x":9,"y":4,"s":1,"i":0},{
"key":"F","x":10,"y":1,"s":1,"i":0},{
"key":"F","x":10,"y":2,"s":1,"i":0},{
"key":"JB","x":10,"y":3,"s":1,"i":0},{
"key":"F","x":10,"y":4,"s":1,"i":0},{
"key":"B","x":10,"y":5,"s":1,"i":0},{
"key":"I","x":10,"y":6,"s":1,"i":0},{
"key":"I","x":10,"y":7,"s":1,"i":0},{
"key":"I","x":10,"y":8,"s":1,"i":0},{
"key":"I","x":10,"y":9,"s":1,"i":0},{
"key":"I","x":10,"y":10,"s":1,"i":0},{
"key":"A","x":11,"y":1,"s":1,"i":0},{
"key":"F","x":11,"y":2,"s":1,"i":0},{
"key":"F","x":11,"y":3,"s":1,"i":0},{
"key":"B","x":11,"y":4,"s":1,"i":0},{
"key":"I","x":11,"y":9,"s":1,"i":0},{
"key":"A","x":12,"y":2,"s":1,"i":0},{
"key":"A","x":12,"y":3,"s":1,"i":0},{
"key":"F","x":12,"y":4,"s":1,"i":0},{
"key":"I","x":12,"y":5,"s":1,"i":0},{
"key":"C","x":12,"y":6,"s":1,"i":0},{
"key":"K","x":12,"y":7,"s":1,"i":0},{
"key":"A","x":12,"y":8,"s":1,"i":0},{
"key":"I","x":12,"y":9,"s":1,"i":0},{
"key":"K","x":13,"y":5,"s":1,"i":0},{
"key":"C","x":13,"y":6,"s":1,"i":0},{
"key":"A","x":13,"y":7,"s":1,"i":0},{
"key":"K","x":13,"y":8,"s":1,"i":0},{
"key":"I","x":14,"y":0,"s":1,"i":0},{
"key":"I","x":14,"y":1,"s":1,"i":0},{
"key":"I","x":14,"y":2,"s":1,"i":0},{
"key":"I","x":14,"y":3,"s":1,"i":0},{
"key":"I","x":14,"y":4,"s":1,"i":0},{
"key":"A","x":14,"y":5,"s":1,"i":0},{
"key":"A","x":14,"y":6,"s":1,"i":0},{
"key":"K","x":14,"y":7,"s":1,"i":0},{
"key":"B","x":14,"y":8,"s":1,"i":0},{
"key":"B","x":14,"y":9,"s":1,"i":0},{
"key":"I","x":15,"y":0,"s":1,"i":0},{
"key":"K","x":15,"y":5,"s":1,"i":0},{
"key":"B","x":15,"y":6,"s":1,"i":0},{
"key":"C","x":15,"y":7,"s":1,"i":0},{
"key":"K","x":15,"y":8,"s":1,"i":0},{
"key":"I","x":16,"y":1,"s":1,"i":0},{
"key":"F","x":16,"y":2,"s":1,"i":0},{
"key":"F","x":16,"y":3,"s":1,"i":0},{
"key":"C","x":16,"y":4,"s":1,"i":0},{
"key":"I","x":16,"y":5,"s":1,"i":0},{
"key":"B","x":16,"y":6,"s":1,"i":0},{
"key":"K","x":16,"y":7,"s":1,"i":0},{
"key":"C","x":16,"y":8,"s":1,"i":0},{
"key":"F","x":17,"y":1,"s":1,"i":0},{
"key":"A","x":17,"y":2,"s":1,"i":0},{
"key":"F","x":17,"y":3,"s":1,"i":0},{
"key":"C","x":17,"y":4,"s":1,"i":0},{
"key":"B","x":18,"y":1,"s":1,"i":0},{
"key":"B","x":18,"y":2,"s":1,"i":0},{
"key":"A","x":18,"y":3,"s":1,"i":0},{
"key":"B","x":18,"y":4,"s":1,"i":0},{
"key":"B","x":18,"y":5,"s":1,"i":0},{
"key":"I","x":18,"y":6,"s":1,"i":0},{
"key":"I","x":18,"y":7,"s":1,"i":0},{
"key":"I","x":18,"y":8,"s":1,"i":0},{
"key":"I","x":18,"y":9,"s":1,"i":0},{
"key":"I","x":18,"y":10,"s":1,"i":0},{
"key":"B","x":19,"y":1,"s":1,"i":0},{
"key":"B","x":19,"y":2,"s":1,"i":0},{
"key":"H","x":19,"y":3,"s":1,"i":0},{
"key":"H","x":19,"y":4,"s":1,"i":0},{
"key":"I","x":19,"y":9,"s":1,"i":0},{
"key":"I","x":20,"y":1,"s":1,"i":0},{
"key":"C","x":20,"y":2,"s":1,"i":0},{
"key":"B","x":20,"y":3,"s":1,"i":0},{
"key":"C","x":20,"y":4,"s":1,"i":0},{
"key":"I","x":20,"y":5,"s":1,"i":0},{
"key":"A1","x":20,"y":6,"s":1,"i":0},{
"key":"F","x":20,"y":7,"s":1,"i":0},{
"key":"B1","x":20,"y":8,"s":1,"i":0},{
"key":"I","x":20,"y":9,"s":1,"i":0},{
"key":"I","x":21,"y":0,"s":1,"i":0},{
"key":"F","x":21,"y":5,"s":1,"i":0},{
"key":"A","x":21,"y":6,"s":1,"i":0},{
"key":"C","x":21,"y":7,"s":1,"i":0},{
"key":"F","x":21,"y":8,"s":1,"i":0},{
"key":"I","x":22,"y":0,"s":1,"i":0},{
"key":"I","x":22,"y":1,"s":1,"i":0},{
"key":"I","x":22,"y":2,"s":1,"i":0},{
"key":"I","x":22,"y":3,"s":1,"i":0},{
"key":"I","x":22,"y":4,"s":1,"i":0},{
"key":"A1","x":22,"y":5,"s":1,"i":0},{
"key":"B","x":22,"y":6,"s":1,"i":0},{
"key":"K","x":22,"y":7,"s":1,"i":0},{
"key":"B","x":22,"y":8,"s":1,"i":0},{
"key":"B1","x":22,"y":9,"s":1,"i":0},{
"key":"F","x":23,"y":5,"s":1,"i":0},{
"key":"C","x":23,"y":6,"s":1,"i":0},{
"key":"A","x":23,"y":7,"s":1,"i":0},{
"key":"F","x":23,"y":8,"s":1,"i":0},{
"key":"C1","x":24,"y":6,"s":1,"i":0},{
"key":"F","x":24,"y":7,"s":1,"i":0},{
"key":"A1","x":24,"y":8,"s":1,"i":0}],"sub
":[{
"key":"S","x":12,"y":6,"s":0,"i":0},{
"key":"S","x":12,"y":8,"s":0,"i":0},{
"key":"S","x":13,"y":6,"s":0,"i":0},{
"key":"S","x":13,"y":7,"s":0,"i":0},{
"key":"S","x":14,"y":5,"s":0,"i":0},{
"key":"S","x":14,"y":6,"s":0,"i":0},{
"key":"S","x":14,"y":8,"s":0,"i":0},{
"key":"S","x":14,"y":9,"s":0,"i":0},{
"key":"S","x":15,"y":6,"s":0,"i":0},{
"key":"S","x":15,"y":7,"s":0,"i":0},{
"key":"S","x":16,"y":6,"s":0,"i":0},{
"key":"S","x":16,"y":8,"s":0,"i":0},{
"key":"L","x":18,"y":1,"s":0,"i":0},{
"key":"L","x":18,"y":2,"s":0,"i":0},{
"key":"Suo","x":18,"y":3,"s":0,"i":0},{
"key":"L","x":18,"y":4,"s":0,"i":0},{
"key":"L","x":18,"y":5,"s":0,"i":0},{
"key":"L","x":20,"y":2,"s":0,"i":0},{
"key":"Suo","x":20,"y":3,"s":0,"i":0},{
"key":"L","x":20,"y":4,"s":0,"i":0}]}