{
"BackCround":{
"backCround_type":1,"bottom_type":2,"skill_type":0},"level":729,"mode":1,"LevelType":{
"Key":"@","Type":2,"Number":1},"Star":{
"star1":120,"star2":35670,"star3":66380},"Gang":{
"Gang1":0,"Gang2":0,"Gang3":0,"Gang4":0,"Gang5":1},"ReadyBubble":{
"R1":0,"R2":0,"R3":0,"R4":0},"BallNumber":18,"TimeLimit":0,"ObjChance":[{
"Key":"C","P":5},{
"Key":"A","P":5},{
"Key":"B","P":5},{
"Key":"D","P":5}],"top":[],"bubble
":[{
"key":"I","x":0,"y":0,"s":1,"i":0},{
"key":"I","x":0,"y":1,"s":1,"i":0},{
"key":"I","x":0,"y":2,"s":1,"i":0},{
"key":"I","x":0,"y":3,"s":1,"i":0},{
"key":"I","x":0,"y":4,"s":1,"i":0},{
"key":"I","x":0,"y":5,"s":1,"i":0},{
"key":"I","x":0,"y":6,"s":1,"i":0},{
"key":"I","x":0,"y":7,"s":1,"i":0},{
"key":"I","x":0,"y":8,"s":1,"i":0},{
"key":"I","x":0,"y":9,"s":1,"i":0},{
"key":"I","x":0,"y":10,"s":1,"i":0},{
"key":"K","x":1,"y":0,"s":1,"i":0},{
"key":"D1","x":1,"y":3,"s":1,"i":0},{
"key":"F","x":1,"y":4,"s":1,"i":0},{
"key":"F","x":1,"y":5,"s":1,"i":0},{
"key":"D1","x":1,"y":6,"s":1,"i":0},{
"key":"K","x":1,"y":9,"s":1,"i":0},{
"key":"I","x":2,"y":0,"s":1,"i":0},{
"key":"@","x":2,"y":2,"s":1,"i":0},{
"key":"F","x":2,"y":3,"s":1,"i":0},{
"key":"K","x":2,"y":4,"s":1,"i":0},{
"key":"J","x":2,"y":5,"s":1,"i":0},{
"key":"K","x":2,"y":6,"s":1,"i":0},{
"key":"F","x":2,"y":7,"s":1,"i":0},{
"key":"@","x":2,"y":8,"s":1,"i":0},{
"key":"I","x":2,"y":10,"s":1,"i":0},{
"key":"I","x":3,"y":0,"s":1,"i":0},{
"key":"@","x":3,"y":1,"s":1,"i":0},{
"key":"F","x":3,"y":2,"s":1,"i":0},{
"key":"K","x":3,"y":3,"s":1,"i":0},{
"key":"P","x":3,"y":4,"s":1,"i":1},{
"key":"P","x":3,"y":5,"s":1,"i":2},{
"key":"K","x":3,"y":6,"s":1,"i":0},{
"key":"F","x":3,"y":7,"s":1,"i":0},{
"key":"@","x":3,"y":8,"s":1,"i":0},{
"key":"I","x":3,"y":9,"s":1,"i":0},{
"key":"I","x":4,"y":0,"s":1,"i":0},{
"key":"AA","x":4,"y":1,"s":1,"i":0},{
"key":"C1","x":4,"y":2,"s":1,"i":0},{
"key":"J","x":4,"y":3,"s":1,"i":0},{
"key":"P","x":4,"y":4,"s":1,"i":3},{
"key":"P","x":4,"y":5,"s":2,"i":0},{
"key":"P","x":4,"y":6,"s":1,"i":4},{
"key":"J","x":4,"y":7,"s":1,"i":0},{
"key":"B1","x":4,"y":8,"s":1,"i":0},{
"key":"AA","x":4,"y":9,"s":1,"i":0},{
"key":"I","x":4,"y":10,"s":1,"i":0},{
"key":"@","x":5,"y":0,"s":1,"i":0},{
"key":"@","x":5,"y":1,"s":1,"i":0},{
"key":"D1","x":5,"y":2,"s":1,"i":0},{
"key":"K","x":5,"y":3,"s":1,"i":0},{
"key":"P","x":5,"y":4,"s":1,"i":5},{
"key":"P","x":5,"y":5,"s":1,"i":6},{
"key":"K","x":5,"y":6,"s":1,"i":0},{
"key":"D1","x":5,"y":7,"s":1,"i":0},{
"key":"@","x":5,"y":8,"s":1,"i":0},{
"key":"@","x":5,"y":9,"s":1,"i":0},{
"key":"I","x":6,"y":0,"s":1,"i":0},{
"key":"F","x":6,"y":2,"s":1,"i":0},{
"key":"F","x":6,"y":3,"s":1,"i":0},{
"key":"K","x":6,"y":4,"s":1,"i":0},{
"key":"J","x":6,"y":5,"s":1,"i":0},{
"key":"K","x":6,"y":6,"s":1,"i":0},{
"key":"F","x":6,"y":7,"s":1,"i":0},{
"key":"F","x":6,"y":8,"s":1,"i":0},{
"key":"I","x":6,"y":10,"s":1,"i":0},{
"key":"I","x":7,"y":0,"s":1,"i":0},{
"key":"F","x":7,"y":2,"s":1,"i":0},{
"key":"F","x":7,"y":3,"s":1,"i":0},{
"key":"A1","x":7,"y":4,"s":1,"i":0},{
"key":"D1","x":7,"y":5,"s":1,"i":0},{
"key":"F","x":7,"y":6,"s":1,"i":0},{
"key":"F","x":7,"y":7,"s":1,"i":0},{
"key":"I","x":7,"y":9,"s":1,"i":0},{
"key":"I","x":8,"y":0,"s":1,"i":0},{
"key":"I","x":8,"y":1,"s":1,"i":0},{
"key":"I","x":8,"y":2,"s":1,"i":0},{
"key":"I","x":8,"y":8,"s":1,"i":0},{
"key":"I","x":8,"y":9,"s":1,"i":0},{
"key":"I","x":8,"y":10,"s":1,"i":0}],"sub
":[]}