{
"BackCround":{
"backCround_type":1,"bottom_type":2,"skill_type":0},"level":234,"mode":1,"LevelType":{
"Key":"@","Type":1,"Number":6},"Star":{
"star1":500,"star2":20000,"star3":40000},"Gang":{
"Gang1":0,"Gang2":0,"Gang3":0,"Gang4":1,"Gang5":0},"ReadyBubble":{
"R1":0,"R2":0,"R3":0,"R4":0},"BallNumber":35,"TimeLimit":0,"ObjChance":[{
"Key":"C","P":5},{
"Key":"A","P":5},{
"Key":"B","P":5},{
"Key":"E","P":5},{
"Key":"D","P":5}],"top":[],"bubble
":[{
"key":"AJ","x":0,"y":2,"s":1,"i":0},{
"key":"A","x":0,"y":3,"s":1,"i":0},{
"key":"B","x":0,"y":7,"s":1,"i":0},{
"key":"DJ","x":0,"y":8,"s":1,"i":0},{
"key":"C","x":1,"y":1,"s":1,"i":0},{
"key":"C","x":1,"y":2,"s":1,"i":0},{
"key":"A","x":1,"y":3,"s":1,"i":0},{
"key":"B","x":1,"y":6,"s":1,"i":0},{
"key":"D","x":1,"y":7,"s":1,"i":0},{
"key":"D","x":1,"y":8,"s":1,"i":0},{
"key":"H","x":2,"y":2,"s":1,"i":0},{
"key":"H","x":2,"y":3,"s":1,"i":0},{
"key":"K","x":2,"y":5,"s":1,"i":0},{
"key":"H","x":2,"y":7,"s":1,"i":0},{
"key":"H","x":2,"y":8,"s":1,"i":0},{
"key":"K","x":3,"y":2,"s":1,"i":0},{
"key":"K","x":3,"y":4,"s":1,"i":0},{
"key":"K","x":3,"y":5,"s":1,"i":0},{
"key":"K","x":3,"y":7,"s":1,"i":0},{
"key":"H","x":4,"y":0,"s":1,"i":0},{
"key":"H","x":4,"y":1,"s":1,"i":0},{
"key":"K","x":4,"y":2,"s":1,"i":0},{
"key":"K","x":4,"y":3,"s":1,"i":0},{
"key":"H","x":4,"y":5,"s":1,"i":0},{
"key":"K","x":4,"y":7,"s":1,"i":0},{
"key":"K","x":4,"y":8,"s":1,"i":0},{
"key":"H","x":4,"y":9,"s":1,"i":0},{
"key":"H","x":4,"y":10,"s":1,"i":0},{
"key":"E","x":5,"y":0,"s":1,"i":0},{
"key":"E","x":5,"y":1,"s":1,"i":0},{
"key":"E1","x":5,"y":2,"s":1,"i":0},{
"key":"E1","x":5,"y":3,"s":1,"i":0},{
"key":"E1","x":5,"y":4,"s":1,"i":0},{
"key":"D1","x":5,"y":5,"s":1,"i":0},{
"key":"D1","x":5,"y":6,"s":1,"i":0},{
"key":"D1","x":5,"y":7,"s":1,"i":0},{
"key":"B1","x":5,"y":8,"s":1,"i":0},{
"key":"B1","x":5,"y":9,"s":1,"i":0},{
"key":"B","x":6,"y":0,"s":1,"i":0},{
"key":"D","x":6,"y":2,"s":1,"i":0},{
"key":"DJ","x":6,"y":5,"s":1,"i":0},{
"key":"C","x":6,"y":8,"s":1,"i":0},{
"key":"A","x":6,"y":10,"s":1,"i":0},{
"key":"B1","x":7,"y":0,"s":1,"i":0},{
"key":"D1","x":7,"y":2,"s":1,"i":0},{
"key":"H","x":7,"y":4,"s":1,"i":0},{
"key":"H","x":7,"y":5,"s":1,"i":0},{
"key":"C1","x":7,"y":7,"s":1,"i":0},{
"key":"A1","x":7,"y":9,"s":1,"i":0},{
"key":"B","x":8,"y":0,"s":1,"i":0},{
"key":"D","x":8,"y":2,"s":1,"i":0},{
"key":"AJ","x":8,"y":5,"s":1,"i":0},{
"key":"C","x":8,"y":8,"s":1,"i":0},{
"key":"A","x":8,"y":10,"s":1,"i":0},{
"key":"E","x":9,"y":0,"s":1,"i":0},{
"key":"E","x":9,"y":1,"s":1,"i":0},{
"key":"B1","x":9,"y":2,"s":1,"i":0},{
"key":"B1","x":9,"y":3,"s":1,"i":0},{
"key":"E1","x":9,"y":4,"s":1,"i":0},{
"key":"C1","x":9,"y":5,"s":1,"i":0},{
"key":"D1","x":9,"y":6,"s":1,"i":0},{
"key":"D1","x":9,"y":7,"s":1,"i":0},{
"key":"B","x":9,"y":8,"s":1,"i":0},{
"key":"B","x":9,"y":9,"s":1,"i":0},{
"key":"H","x":10,"y":0,"s":1,"i":0},{
"key":"H","x":10,"y":5,"s":1,"i":0},{
"key":"H","x":10,"y":10,"s":1,"i":0},{
"key":"H","x":11,"y":0,"s":1,"i":0},{
"key":"H","x":11,"y":1,"s":1,"i":0},{
"key":"H","x":11,"y":4,"s":1,"i":0},{
"key":"H","x":11,"y":5,"s":1,"i":0},{
"key":"H","x":11,"y":8,"s":1,"i":0},{
"key":"H","x":11,"y":9,"s":1,"i":0},{
"key":"A","x":12,"y":0,"s":1,"i":0},{
"key":"A","x":12,"y":1,"s":1,"i":0},{
"key":"B","x":12,"y":2,"s":1,"i":0},{
"key":"E","x":12,"y":3,"s":1,"i":0},{
"key":"E","x":12,"y":4,"s":1,"i":0},{
"key":"C","x":12,"y":6,"s":1,"i":0},{
"key":"C","x":12,"y":7,"s":1,"i":0},{
"key":"D","x":12,"y":8,"s":1,"i":0},{
"key":"D","x":12,"y":9,"s":1,"i":0},{
"key":"E","x":12,"y":10,"s":1,"i":0},{
"key":"B","x":13,"y":1,"s":1,"i":0},{
"key":"D","x":13,"y":8,"s":1,"i":0},{
"key":"E","x":14,"y":1,"s":1,"i":0},{
"key":"B","x":14,"y":2,"s":1,"i":0},{
"key":"D","x":14,"y":4,"s":1,"i":0},{
"key":"AJ","x":14,"y":5,"s":1,"i":0},{
"key":"C","x":14,"y":6,"s":1,"i":0},{
"key":"E","x":14,"y":8,"s":1,"i":0},{
"key":"B","x":14,"y":9,"s":1,"i":0},{
"key":"E","x":15,"y":0,"s":1,"i":0},{
"key":"C","x":15,"y":2,"s":1,"i":0},{
"key":"C","x":15,"y":3,"s":1,"i":0},{
"key":"D","x":15,"y":4,"s":1,"i":0},{
"key":"C","x":15,"y":5,"s":1,"i":0},{
"key":"B","x":15,"y":6,"s":1,"i":0},{
"key":"E","x":15,"y":7,"s":1,"i":0},{
"key":"B","x":15,"y":9,"s":1,"i":0},{
"key":"A","x":16,"y":0,"s":1,"i":0},{
"key":"D","x":16,"y":2,"s":1,"i":0},{
"key":"C","x":16,"y":3,"s":1,"i":0},{
"key":"B","x":16,"y":4,"s":1,"i":0},{
"key":"C","x":16,"y":6,"s":1,"i":0},{
"key":"B","x":16,"y":7,"s":1,"i":0},{
"key":"A","x":16,"y":8,"s":1,"i":0},{
"key":"D","x":16,"y":10,"s":1,"i":0},{
"key":"A","x":17,"y":0,"s":1,"i":0},{
"key":"A","x":17,"y":1,"s":1,"i":0},{
"key":"D","x":17,"y":2,"s":1,"i":0},{
"key":"B","x":17,"y":3,"s":1,"i":0},{
"key":"B","x":17,"y":6,"s":1,"i":0},{
"key":"A","x":17,"y":7,"s":1,"i":0},{
"key":"A","x":17,"y":8,"s":1,"i":0},{
"key":"D","x":17,"y":9,"s":1,"i":0},{
"key":"C","x":18,"y":3,"s":1,"i":0},{
"key":"D","x":18,"y":4,"s":1,"i":0},{
"key":"J","x":18,"y":5,"s":1,"i":0},{
"key":"D","x":18,"y":6,"s":1,"i":0},{
"key":"E","x":18,"y":7,"s":1,"i":0},{
"key":"E","x":19,"y":1,"s":1,"i":0},{
"key":"C","x":19,"y":2,"s":1,"i":0},{
"key":"D","x":19,"y":3,"s":1,"i":0},{
"key":"K","x":19,"y":4,"s":1,"i":0},{
"key":"K","x":19,"y":5,"s":1,"i":0},{
"key":"D","x":19,"y":6,"s":1,"i":0},{
"key":"E","x":19,"y":7,"s":1,"i":0},{
"key":"D","x":19,"y":8,"s":1,"i":0},{
"key":"E","x":20,"y":1,"s":1,"i":0},{
"key":"B","x":20,"y":2,"s":1,"i":0},{
"key":"A","x":20,"y":3,"s":1,"i":0},{
"key":"K","x":20,"y":4,"s":1,"i":0},{
"key":"CJ","x":20,"y":5,"s":1,"i":0},{
"key":"K","x":20,"y":6,"s":1,"i":0},{
"key":"C","x":20,"y":7,"s":1,"i":0},{
"key":"B","x":20,"y":8,"s":1,"i":0},{
"key":"D","x":20,"y":9,"s":1,"i":0},{
"key":"D","x":21,"y":0,"s":1,"i":0},{
"key":"D","x":21,"y":1,"s":1,"i":0},{
"key":"B","x":21,"y":2,"s":1,"i":0},{
"key":"A","x":21,"y":3,"s":1,"i":0},{
"key":"K","x":21,"y":4,"s":1,"i":0},{
"key":"K","x":21,"y":5,"s":1,"i":0},{
"key":"C","x":21,"y":6,"s":1,"i":0},{
"key":"B","x":21,"y":7,"s":1,"i":0},{
"key":"C","x":21,"y":8,"s":1,"i":0},{
"key":"C","x":21,"y":9,"s":1,"i":0},{
"key":"A","x":22,"y":0,"s":1,"i":0},{
"key":"A","x":22,"y":1,"s":1,"i":0},{
"key":"H","x":22,"y":2,"s":1,"i":0},{
"key":"B","x":22,"y":3,"s":1,"i":0},{
"key":"E","x":22,"y":4,"s":1,"i":0},{
"key":"E","x":22,"y":5,"s":1,"i":0},{
"key":"E","x":22,"y":6,"s":1,"i":0},{
"key":"B","x":22,"y":7,"s":1,"i":0},{
"key":"H","x":22,"y":8,"s":1,"i":0},{
"key":"A","x":22,"y":9,"s":1,"i":0},{
"key":"A","x":22,"y":10,"s":1,"i":0}],"sub
":[],"down
":[],"jysub

":[]}