{
"BackCround":{
"backCround_type":1,"bottom_type":2,"skill_type":0},"level":10015,"mode":1,"LevelType":{
"Key":"@","Type":1,"Number":4},"Star":{
"star1":11111,"star2":35000,"star3":42000},"Gang":{
"Gang1":0,"Gang2":0,"Gang3":1,"Gang4":0,"Gang5":0},"BallNumber":16,"TimeLimit":0,"ObjChance":[{
"Key":"C","P":4},{
"Key":"A","P":4},{
"Key":"B","P":4},{
"Key":"E","P":4}],"top":[],"bubble
":[{
"key":"K","x":0,"y":0,"s":1,"i":0},{
"key":"C1","x":0,"y":1,"s":1,"i":0},{
"key":"C1","x":0,"y":2,"s":1,"i":0},{
"key":"C1","x":0,"y":3,"s":1,"i":0},{
"key":"C1","x":0,"y":4,"s":1,"i":0},{
"key":"C1","x":0,"y":6,"s":1,"i":0},{
"key":"C1","x":0,"y":7,"s":1,"i":0},{
"key":"C1","x":0,"y":8,"s":1,"i":0},{
"key":"C1","x":0,"y":9,"s":1,"i":0},{
"key":"K","x":0,"y":10,"s":1,"i":0},{
"key":"EJ","x":1,"y":0,"s":1,"i":0},{
"key":"H","x":1,"y":1,"s":1,"i":0},{
"key":"BJ","x":1,"y":2,"s":1,"i":0},{
"key":"AB","x":1,"y":3,"s":1,"i":0},{
"key":"AA","x":1,"y":6,"s":1,"i":0},{
"key":"AJ","x":1,"y":7,"s":1,"i":0},{
"key":"H","x":1,"y":8,"s":1,"i":0},{
"key":"CJ","x":1,"y":9,"s":1,"i":0},{
"key":"K","x":2,"y":0,"s":1,"i":0},{
"key":"C1","x":2,"y":1,"s":1,"i":0},{
"key":"C1","x":2,"y":2,"s":1,"i":0},{
"key":"C1","x":2,"y":3,"s":1,"i":0},{
"key":"C1","x":2,"y":4,"s":1,"i":0},{
"key":"C1","x":2,"y":6,"s":1,"i":0},{
"key":"C1","x":2,"y":7,"s":1,"i":0},{
"key":"C1","x":2,"y":8,"s":1,"i":0},{
"key":"C1","x":2,"y":9,"s":1,"i":0},{
"key":"K","x":2,"y":10,"s":1,"i":0},{
"key":"@","x":3,"y":0,"s":1,"i":0},{
"key":"H","x":3,"y":1,"s":1,"i":0},{
"key":"@","x":3,"y":2,"s":1,"i":0},{
"key":"@","x":3,"y":3,"s":1,"i":0},{
"key":"@","x":3,"y":6,"s":1,"i":0},{
"key":"@","x":3,"y":7,"s":1,"i":0},{
"key":"H","x":3,"y":8,"s":1,"i":0},{
"key":"@","x":3,"y":9,"s":1,"i":0},{
"key":"K","x":4,"y":0,"s":1,"i":0},{
"key":"C1","x":4,"y":1,"s":1,"i":0},{
"key":"C1","x":4,"y":2,"s":1,"i":0},{
"key":"C1","x":4,"y":3,"s":1,"i":0},{
"key":"C1","x":4,"y":4,"s":1,"i":0},{
"key":"C1","x":4,"y":6,"s":1,"i":0},{
"key":"C1","x":4,"y":7,"s":1,"i":0},{
"key":"C1","x":4,"y":8,"s":1,"i":0},{
"key":"C1","x":4,"y":9,"s":1,"i":0},{
"key":"K","x":4,"y":10,"s":1,"i":0},{
"key":"@","x":5,"y":0,"s":1,"i":0},{
"key":"H","x":5,"y":1,"s":1,"i":0},{
"key":"@","x":5,"y":2,"s":1,"i":0},{
"key":"@","x":5,"y":3,"s":1,"i":0},{
"key":"@","x":5,"y":6,"s":1,"i":0},{
"key":"@","x":5,"y":7,"s":1,"i":0},{
"key":"H","x":5,"y":8,"s":1,"i":0},{
"key":"@","x":5,"y":9,"s":1,"i":0},{
"key":"K","x":6,"y":0,"s":1,"i":0},{
"key":"C1","x":6,"y":1,"s":1,"i":0},{
"key":"C1","x":6,"y":2,"s":1,"i":0},{
"key":"C1","x":6,"y":3,"s":1,"i":0},{
"key":"C1","x":6,"y":4,"s":1,"i":0},{
"key":"C1","x":6,"y":6,"s":1,"i":0},{
"key":"C1","x":6,"y":7,"s":1,"i":0},{
"key":"C1","x":6,"y":8,"s":1,"i":0},{
"key":"C1","x":6,"y":9,"s":1,"i":0},{
"key":"K","x":6,"y":10,"s":1,"i":0},{
"key":"G","x":7,"y":0,"s":1,"i":0},{
"key":"H","x":7,"y":1,"s":1,"i":0},{
"key":"G","x":7,"y":2,"s":1,"i":0},{
"key":"G","x":7,"y":3,"s":1,"i":0},{
"key":"G","x":7,"y":6,"s":1,"i":0},{
"key":"G","x":7,"y":7,"s":1,"i":0},{
"key":"H","x":7,"y":8,"s":1,"i":0},{
"key":"G","x":7,"y":9,"s":1,"i":0},{
"key":"K","x":8,"y":0,"s":1,"i":0},{
"key":"A","x":8,"y":1,"s":1,"i":0},{
"key":"E","x":8,"y":2,"s":1,"i":0},{
"key":"A","x":8,"y":3,"s":1,"i":0},{
"key":"B","x":8,"y":4,"s":1,"i":0},{
"key":"C","x":8,"y":6,"s":1,"i":0},{
"key":"B","x":8,"y":7,"s":1,"i":0},{
"key":"A","x":8,"y":8,"s":1,"i":0},{
"key":"E","x":8,"y":9,"s":1,"i":0},{
"key":"K","x":8,"y":10,"s":1,"i":0},{
"key":"AA","x":9,"y":0,"s":1,"i":0},{
"key":"E","x":9,"y":1,"s":1,"i":0},{
"key":"B","x":9,"y":2,"s":1,"i":0},{
"key":"A","x":9,"y":3,"s":1,"i":0},{
"key":"E","x":9,"y":4,"s":1,"i":0},{
"key":"A","x":9,"y":5,"s":1,"i":0},{
"key":"A","x":9,"y":6,"s":1,"i":0},{
"key":"B","x":9,"y":7,"s":1,"i":0},{
"key":"A","x":9,"y":8,"s":1,"i":0},{
"key":"AE","x":9,"y":9,"s":1,"i":0},{
"key":"K","x":10,"y":0,"s":1,"i":0},{
"key":"A","x":10,"y":1,"s":1,"i":0},{
"key":"B","x":10,"y":2,"s":1,"i":0},{
"key":"C","x":10,"y":3,"s":1,"i":0},{
"key":"E","x":10,"y":4,"s":1,"i":0},{
"key":"K","x":10,"y":5,"s":1,"i":0},{
"key":"B","x":10,"y":6,"s":1,"i":0},{
"key":"C","x":10,"y":7,"s":1,"i":0},{
"key":"C","x":10,"y":8,"s":1,"i":0},{
"key":"E","x":10,"y":9,"s":1,"i":0},{
"key":"K","x":10,"y":10,"s":1,"i":0},{
"key":"@","x":11,"y":0,"s":1,"i":0},{
"key":"@","x":11,"y":1,"s":1,"i":0},{
"key":"C","x":11,"y":3,"s":1,"i":0},{
"key":"A","x":11,"y":4,"s":1,"i":0},{
"key":"B","x":11,"y":5,"s":1,"i":0},{
"key":"E","x":11,"y":6,"s":1,"i":0},{
"key":"@","x":11,"y":8,"s":1,"i":0},{
"key":"@","x":11,"y":9,"s":1,"i":0},{
"key":"K","x":12,"y":0,"s":1,"i":0},{
"key":"A1","x":12,"y":1,"s":1,"i":0},{
"key":"@","x":12,"y":2,"s":1,"i":0},{
"key":"A","x":12,"y":4,"s":1,"i":0},{
"key":"K","x":12,"y":5,"s":1,"i":0},{
"key":"C","x":12,"y":6,"s":1,"i":0},{
"key":"@","x":12,"y":8,"s":1,"i":0},{
"key":"A1","x":12,"y":9,"s":1,"i":0},{
"key":"K","x":12,"y":10,"s":1,"i":0},{
"key":"@","x":13,"y":0,"s":1,"i":0},{
"key":"@","x":13,"y":1,"s":1,"i":0},{
"key":"G","x":13,"y":3,"s":1,"i":0},{
"key":"C","x":13,"y":4,"s":1,"i":0},{
"key":"E","x":13,"y":5,"s":1,"i":0},{
"key":"G","x":13,"y":6,"s":1,"i":0},{
"key":"@","x":13,"y":8,"s":1,"i":0},{
"key":"@","x":13,"y":9,"s":1,"i":0},{
"key":"G","x":14,"y":0,"s":1,"i":0},{
"key":"G","x":14,"y":1,"s":1,"i":0},{
"key":"G","x":14,"y":2,"s":1,"i":0},{
"key":"B","x":14,"y":4,"s":1,"i":0},{
"key":"TC","x":14,"y":5,"s":1,"i":0},{
"key":"E","x":14,"y":6,"s":1,"i":0},{
"key":"G","x":14,"y":8,"s":1,"i":0},{
"key":"G","x":14,"y":9,"s":1,"i":0},{
"key":"G","x":14,"y":10,"s":1,"i":0},{
"key":"@","x":15,"y":0,"s":1,"i":0},{
"key":"@","x":15,"y":1,"s":1,"i":0},{
"key":"G","x":15,"y":3,"s":1,"i":0},{
"key":"B","x":15,"y":4,"s":1,"i":0},{
"key":"A","x":15,"y":5,"s":1,"i":0},{
"key":"G","x":15,"y":6,"s":1,"i":0},{
"key":"@","x":15,"y":8,"s":1,"i":0},{
"key":"@","x":15,"y":9,"s":1,"i":0},{
"key":"K","x":16,"y":0,"s":1,"i":0},{
"key":"A1","x":16,"y":1,"s":1,"i":0},{
"key":"@","x":16,"y":2,"s":1,"i":0},{
"key":"A","x":16,"y":4,"s":1,"i":0},{
"key":"K","x":16,"y":5,"s":1,"i":0},{
"key":"C","x":16,"y":6,"s":1,"i":0},{
"key":"@","x":16,"y":8,"s":1,"i":0},{
"key":"C1","x":16,"y":9,"s":1,"i":0},{
"key":"K","x":16,"y":10,"s":1,"i":0},{
"key":"@","x":17,"y":0,"s":1,"i":0},{
"key":"@","x":17,"y":1,"s":1,"i":0},{
"key":"G","x":17,"y":3,"s":1,"i":0},{
"key":"C","x":17,"y":4,"s":1,"i":0},{
"key":"E","x":17,"y":5,"s":1,"i":0},{
"key":"G","x":17,"y":6,"s":1,"i":0},{
"key":"@","x":17,"y":8,"s":1,"i":0},{
"key":"@","x":17,"y":9,"s":1,"i":0},{
"key":"G","x":18,"y":0,"s":1,"i":0},{
"key":"G","x":18,"y":1,"s":1,"i":0},{
"key":"G","x":18,"y":2,"s":1,"i":0},{
"key":"E","x":18,"y":4,"s":1,"i":0},{
"key":"K","x":18,"y":5,"s":1,"i":0},{
"key":"B","x":18,"y":6,"s":1,"i":0},{
"key":"G","x":18,"y":8,"s":1,"i":0},{
"key":"G","x":18,"y":9,"s":1,"i":0},{
"key":"G","x":18,"y":10,"s":1,"i":0},{
"key":"C","x":19,"y":0,"s":1,"i":0},{
"key":"A","x":19,"y":1,"s":1,"i":0},{
"key":"G","x":19,"y":3,"s":1,"i":0},{
"key":"B","x":19,"y":4,"s":1,"i":0},{
"key":"A","x":19,"y":5,"s":1,"i":0},{
"key":"G","x":19,"y":6,"s":1,"i":0},{
"key":"E","x":19,"y":8,"s":1,"i":0},{
"key":"E","x":19,"y":9,"s":1,"i":0},{
"key":"K","x":20,"y":0,"s":1,"i":0},{
"key":"C","x":20,"y":1,"s":1,"i":0},{
"key":"A","x":20,"y":2,"s":1,"i":0},{
"key":"C","x":20,"y":4,"s":1,"i":0},{
"key":"K","x":20,"y":5,"s":1,"i":0},{
"key":"A","x":20,"y":6,"s":1,"i":0},{
"key":"B","x":20,"y":8,"s":1,"i":0},{
"key":"A","x":20,"y":9,"s":1,"i":0},{
"key":"K","x":20,"y":10,"s":1,"i":0},{
"key":"B","x":21,"y":0,"s":1,"i":0},{
"key":"B","x":21,"y":1,"s":1,"i":0},{
"key":"G","x":21,"y":3,"s":1,"i":0},{
"key":"C","x":21,"y":4,"s":1,"i":0},{
"key":"C","x":21,"y":5,"s":1,"i":0},{
"key":"G","x":21,"y":6,"s":1,"i":0},{
"key":"B","x":21,"y":8,"s":1,"i":0},{
"key":"A","x":21,"y":9,"s":1,"i":0}],"sub
":[]}