{
"BackCround":{
"backCround_type":1,"bottom_type":2,"skill_type":0},"level":182,"mode":1,"LevelType":{
"Key":"@","Type":1,"Number":4},"Star":{
"star1":5000,"star2":3000,"star3":60000},"Gang":{
"Gang1":1,"Gang2":1,"Gang3":0,"Gang4":0,"Gang5":1},"ReadyBubble":{
"R1":0,"R2":0,"R3":0,"R4":0},"BallNumber":29,"TimeLimit":0,"ObjChance":[{
"Key":"C","P":5},{
"Key":"A","P":5},{
"Key":"B","P":5},{
"Key":"D","P":5}],"top":[],"bubble
":[{
"key":"CJ","x":0,"y":1,"s":1,"i":0},{
"key":"AJ","x":0,"y":2,"s":1,"i":0},{
"key":"BJ","x":0,"y":3,"s":1,"i":0},{
"key":"DJ","x":0,"y":4,"s":1,"i":0},{
"key":"@","x":1,"y":1,"s":1,"i":0},{
"key":"@","x":1,"y":2,"s":1,"i":0},{
"key":"@","x":1,"y":3,"s":1,"i":0},{
"key":"@","x":1,"y":4,"s":1,"i":0},{
"key":"C","x":2,"y":2,"s":1,"i":0},{
"key":"C","x":2,"y":3,"s":1,"i":0},{
"key":"B","x":2,"y":4,"s":1,"i":0},{
"key":"B","x":2,"y":5,"s":1,"i":0},{
"key":"D","x":3,"y":1,"s":1,"i":0},{
"key":"@","x":3,"y":2,"s":1,"i":0},{
"key":"@","x":3,"y":3,"s":1,"i":0},{
"key":"A","x":3,"y":4,"s":1,"i":0},{
"key":"C","x":3,"y":5,"s":1,"i":0},{
"key":"D","x":4,"y":1,"s":1,"i":0},{
"key":"A","x":4,"y":2,"s":1,"i":0},{
"key":"A","x":4,"y":3,"s":1,"i":0},{
"key":"B1","x":4,"y":4,"s":1,"i":0},{
"key":"A","x":4,"y":5,"s":1,"i":0},{
"key":"C","x":4,"y":6,"s":1,"i":0},{
"key":"A","x":5,"y":0,"s":1,"i":0},{
"key":"F","x":5,"y":1,"s":1,"i":0},{
"key":"J","x":5,"y":2,"s":1,"i":0},{
"key":"C","x":5,"y":3,"s":1,"i":0},{
"key":"B1","x":5,"y":4,"s":1,"i":0},{
"key":"D","x":5,"y":5,"s":1,"i":0},{
"key":"A","x":5,"y":6,"s":1,"i":0},{
"key":"A","x":6,"y":0,"s":1,"i":0},{
"key":"F","x":6,"y":1,"s":1,"i":0},{
"key":"F","x":6,"y":2,"s":1,"i":0},{
"key":"@","x":6,"y":3,"s":1,"i":0},{
"key":"C","x":6,"y":4,"s":1,"i":0},{
"key":"B1","x":6,"y":5,"s":1,"i":0},{
"key":"D","x":6,"y":6,"s":1,"i":0},{
"key":"A","x":6,"y":7,"s":1,"i":0},{
"key":"D","x":7,"y":0,"s":1,"i":0},{
"key":"F","x":7,"y":1,"s":1,"i":0},{
"key":"F","x":7,"y":2,"s":1,"i":0},{
"key":"@","x":7,"y":3,"s":1,"i":0},{
"key":"B","x":7,"y":4,"s":1,"i":0},{
"key":"B1","x":7,"y":5,"s":1,"i":0},{
"key":"A","x":7,"y":6,"s":1,"i":0},{
"key":"B","x":7,"y":7,"s":1,"i":0},{
"key":"D","x":8,"y":1,"s":1,"i":0},{
"key":"F","x":8,"y":2,"s":1,"i":0},{
"key":"F","x":8,"y":3,"s":1,"i":0},{
"key":"@","x":8,"y":4,"s":1,"i":0},{
"key":"B","x":8,"y":5,"s":1,"i":0},{
"key":"B1","x":8,"y":6,"s":1,"i":0},{
"key":"D","x":8,"y":7,"s":1,"i":0},{
"key":"B","x":8,"y":8,"s":1,"i":0},{
"key":"A","x":9,"y":1,"s":1,"i":0},{
"key":"F","x":9,"y":2,"s":1,"i":0},{
"key":"F","x":9,"y":3,"s":1,"i":0},{
"key":"@","x":9,"y":4,"s":1,"i":0},{
"key":"A","x":9,"y":5,"s":1,"i":0},{
"key":"B1","x":9,"y":6,"s":1,"i":0},{
"key":"D","x":9,"y":7,"s":1,"i":0},{
"key":"D","x":9,"y":8,"s":1,"i":0},{
"key":"A","x":10,"y":2,"s":1,"i":0},{
"key":"F","x":10,"y":3,"s":1,"i":0},{
"key":"F","x":10,"y":4,"s":1,"i":0},{
"key":"D","x":10,"y":5,"s":1,"i":0},{
"key":"C","x":10,"y":6,"s":1,"i":0},{
"key":"C","x":10,"y":7,"s":1,"i":0},{
"key":"J","x":10,"y":8,"s":1,"i":0},{
"key":"C","x":10,"y":9,"s":1,"i":0},{
"key":"C","x":11,"y":1,"s":1,"i":0},{
"key":"B","x":11,"y":2,"s":1,"i":0},{
"key":"F","x":11,"y":3,"s":1,"i":0},{
"key":"D","x":11,"y":4,"s":1,"i":0},{
"key":"A","x":11,"y":5,"s":1,"i":0},{
"key":"A","x":11,"y":6,"s":1,"i":0},{
"key":"@","x":11,"y":7,"s":1,"i":0},{
"key":"A","x":11,"y":8,"s":1,"i":0},{
"key":"C","x":11,"y":9,"s":1,"i":0},{
"key":"C","x":12,"y":1,"s":1,"i":0},{
"key":"@","x":12,"y":2,"s":1,"i":0},{
"key":"B","x":12,"y":3,"s":1,"i":0},{
"key":"D","x":12,"y":4,"s":1,"i":0},{
"key":"A","x":12,"y":5,"s":1,"i":0},{
"key":"B","x":12,"y":6,"s":1,"i":0},{
"key":"B","x":12,"y":7,"s":1,"i":0},{
"key":"@","x":12,"y":8,"s":1,"i":0},{
"key":"A","x":12,"y":9,"s":1,"i":0},{
"key":"A","x":13,"y":0,"s":1,"i":0},{
"key":"@","x":13,"y":1,"s":1,"i":0},{
"key":"D","x":13,"y":2,"s":1,"i":0},{
"key":"@","x":13,"y":3,"s":1,"i":0},{
"key":"@","x":13,"y":4,"s":1,"i":0},{
"key":"@","x":13,"y":5,"s":1,"i":0},{
"key":"C","x":13,"y":6,"s":1,"i":0},{
"key":"D","x":13,"y":7,"s":1,"i":0},{
"key":"A","x":13,"y":8,"s":1,"i":0},{
"key":"A","x":14,"y":0,"s":1,"i":0},{
"key":"A","x":14,"y":1,"s":1,"i":0},{
"key":"D","x":14,"y":2,"s":1,"i":0},{
"key":"A","x":14,"y":3,"s":1,"i":0},{
"key":"D","x":14,"y":4,"s":1,"i":0},{
"key":"A","x":14,"y":5,"s":1,"i":0},{
"key":"C","x":14,"y":6,"s":1,"i":0},{
"key":"C","x":14,"y":7,"s":1,"i":0},{
"key":"D","x":14,"y":8,"s":1,"i":0},{
"key":"D","x":15,"y":0,"s":1,"i":0},{
"key":"@","x":15,"y":1,"s":1,"i":0},{
"key":"@","x":15,"y":2,"s":1,"i":0},{
"key":"A","x":15,"y":3,"s":1,"i":0},{
"key":"D","x":15,"y":4,"s":1,"i":0},{
"key":"A","x":15,"y":5,"s":1,"i":0},{
"key":"@","x":15,"y":6,"s":1,"i":0},{
"key":"@","x":15,"y":7,"s":1,"i":0},{
"key":"A","x":15,"y":8,"s":1,"i":0},{
"key":"D","x":16,"y":1,"s":1,"i":0},{
"key":"J","x":16,"y":2,"s":1,"i":0},{
"key":"C","x":16,"y":3,"s":1,"i":0},{
"key":"C","x":16,"y":4,"s":1,"i":0},{
"key":"A","x":16,"y":5,"s":1,"i":0},{
"key":"A","x":16,"y":6,"s":1,"i":0},{
"key":"D","x":16,"y":7,"s":1,"i":0},{
"key":"D","x":16,"y":8,"s":1,"i":0},{
"key":"A","x":16,"y":9,"s":1,"i":0},{
"key":"A","x":17,"y":1,"s":1,"i":0},{
"key":"A","x":17,"y":2,"s":1,"i":0},{
"key":"D1","x":17,"y":3,"s":1,"i":0},{
"key":"C","x":17,"y":4,"s":1,"i":0},{
"key":"D","x":17,"y":5,"s":1,"i":0},{
"key":"F","x":17,"y":6,"s":1,"i":0},{
"key":"F","x":17,"y":7,"s":1,"i":0},{
"key":"J","x":17,"y":8,"s":1,"i":0},{
"key":"B","x":17,"y":9,"s":1,"i":0},{
"key":"A","x":18,"y":2,"s":1,"i":0},{
"key":"D1","x":18,"y":3,"s":1,"i":0},{
"key":"C","x":18,"y":4,"s":1,"i":0},{
"key":"D","x":18,"y":5,"s":1,"i":0},{
"key":"F","x":18,"y":6,"s":1,"i":0},{
"key":"F","x":18,"y":7,"s":1,"i":0},{
"key":"A","x":18,"y":8,"s":1,"i":0},{
"key":"B","x":18,"y":9,"s":1,"i":0},{
"key":"C","x":19,"y":1,"s":1,"i":0},{
"key":"D1","x":19,"y":2,"s":1,"i":0},{
"key":"A","x":19,"y":3,"s":1,"i":0},{
"key":"@","x":19,"y":4,"s":1,"i":0},{
"key":"F","x":19,"y":5,"s":1,"i":0},{
"key":"F","x":19,"y":6,"s":1,"i":0},{
"key":"A","x":19,"y":7,"s":1,"i":0},{
"key":"D","x":19,"y":8,"s":1,"i":0},{
"key":"C","x":20,"y":1,"s":1,"i":0},{
"key":"D1","x":20,"y":2,"s":1,"i":0},{
"key":"A","x":20,"y":3,"s":1,"i":0},{
"key":"@","x":20,"y":4,"s":1,"i":0},{
"key":"F","x":20,"y":5,"s":1,"i":0},{
"key":"F","x":20,"y":6,"s":1,"i":0},{
"key":"D","x":20,"y":7,"s":1,"i":0},{
"key":"D","x":20,"y":8,"s":1,"i":0},{
"key":"A","x":21,"y":0,"s":1,"i":0},{
"key":"D1","x":21,"y":1,"s":1,"i":0},{
"key":"B","x":21,"y":2,"s":1,"i":0},{
"key":"@","x":21,"y":3,"s":1,"i":0},{
"key":"F","x":21,"y":4,"s":1,"i":0},{
"key":"F","x":21,"y":5,"s":1,"i":0},{
"key":"A","x":21,"y":6,"s":1,"i":0},{
"key":"A","x":21,"y":7,"s":1,"i":0},{
"key":"A","x":22,"y":0,"s":1,"i":0},{
"key":"D1","x":22,"y":1,"s":1,"i":0},{
"key":"B","x":22,"y":2,"s":1,"i":0},{
"key":"@","x":22,"y":3,"s":1,"i":0},{
"key":"F","x":22,"y":4,"s":1,"i":0},{
"key":"F","x":22,"y":5,"s":1,"i":0},{
"key":"C","x":22,"y":6,"s":1,"i":0},{
"key":"A","x":22,"y":7,"s":1,"i":0},{
"key":"C","x":23,"y":0,"s":1,"i":0},{
"key":"C","x":23,"y":1,"s":1,"i":0},{
"key":"A","x":23,"y":2,"s":1,"i":0},{
"key":"A","x":23,"y":3,"s":1,"i":0},{
"key":"A","x":23,"y":4,"s":1,"i":0},{
"key":"C","x":23,"y":5,"s":1,"i":0},{
"key":"C","x":23,"y":6,"s":1,"i":0},{
"key":"D","x":24,"y":0,"s":1,"i":0},{
"key":"A","x":24,"y":1,"s":1,"i":0},{
"key":"B","x":24,"y":2,"s":1,"i":0},{
"key":"D","x":24,"y":3,"s":1,"i":0},{
"key":"D","x":24,"y":4,"s":1,"i":0},{
"key":"B","x":24,"y":5,"s":1,"i":0},{
"key":"A","x":24,"y":6,"s":1,"i":0},{
"key":"D","x":25,"y":0,"s":1,"i":0},{
"key":"A","x":25,"y":1,"s":1,"i":0},{
"key":"B","x":25,"y":2,"s":1,"i":0},{
"key":"A","x":25,"y":3,"s":1,"i":0},{
"key":"B","x":25,"y":4,"s":1,"i":0},{
"key":"A","x":25,"y":5,"s":1,"i":0}],"sub
":[{
"key":"S","x":2,"y":3,"s":0,"i":0},{
"key":"S","x":2,"y":4,"s":0,"i":0},{
"key":"S","x":4,"y":2,"s":0,"i":0},{
"key":"S","x":4,"y":3,"s":0,"i":0},{
"key":"S","x":4,"y":5,"s":0,"i":0},{
"key":"S","x":5,"y":5,"s":0,"i":0},{
"key":"S","x":6,"y":6,"s":0,"i":0},{
"key":"S","x":7,"y":6,"s":0,"i":0},{
"key":"S","x":10,"y":5,"s":0,"i":0},{
"key":"S","x":11,"y":4,"s":0,"i":0},{
"key":"S","x":11,"y":5,"s":0,"i":0},{
"key":"S","x":11,"y":6,"s":0,"i":0},{
"key":"S","x":12,"y":4,"s":0,"i":0},{
"key":"S","x":14,"y":5,"s":0,"i":0},{
"key":"S","x":15,"y":5,"s":0,"i":0},{
"key":"S","x":16,"y":4,"s":0,"i":0},{
"key":"S","x":16,"y":5,"s":0,"i":0},{
"key":"S","x":16,"y":6,"s":0,"i":0},{
"key":"S","x":16,"y":7,"s":0,"i":0},{
"key":"S","x":17,"y":5,"s":0,"i":0},{
"key":"S","x":18,"y":5,"s":0,"i":0},{
"key":"S","x":23,"y":2,"s":0,"i":0},{
"key":"S","x":23,"y":3,"s":0,"i":0},{
"key":"S","x":23,"y":4,"s":0,"i":0},{
"key":"S","x":24,"y":2,"s":0,"i":0},{
"key":"S","x":24,"y":3,"s":0,"i":0},{
"key":"S","x":24,"y":4,"s":0,"i":0},{
"key":"S","x":24,"y":5,"s":0,"i":0},{
"key":"S","x":25,"y":2,"s":0,"i":0},{
"key":"S","x":25,"y":3,"s":0,"i":0},{
"key":"S","x":25,"y":4,"s":0,"i":0}],"down
":[],"jysub

":[]}