{
"BackCround":{
"backCround_type":1,"bottom_type":2,"skill_type":0},"level":1,"mode":1,"LevelType":{
"Key":"@","Type":1,"Number":8},"Star":{
"star1":500,"star2":3000,"star3":8000},"Gang":{
"Gang1":0,"Gang2":0,"Gang3":1,"Gang4":0,"Gang5":0},"ReadyBubble":{
"R1":1,"R2":3,"R3":2,"R4":0},"BallNumber":28,"TimeLimit":0,"ObjChance":[{
"Key":"C","P":2},{
"Key":"A","P":1},{
"Key":"D","P":1}],"top":[],"bubble
":[{
"key":"C","x":0,"y":0,"s":1,"i":0},{
"key":"C","x":0,"y":1,"s":1,"i":0},{
"key":"C","x":0,"y":2,"s":1,"i":0},{
"key":"C","x":0,"y":3,"s":1,"i":0},{
"key":"C","x":0,"y":4,"s":1,"i":0},{
"key":"CJ","x":0,"y":5,"s":1,"i":0},{
"key":"C","x":0,"y":6,"s":1,"i":0},{
"key":"C","x":0,"y":7,"s":1,"i":0},{
"key":"C","x":0,"y":8,"s":1,"i":0},{
"key":"C","x":0,"y":9,"s":1,"i":0},{
"key":"C","x":0,"y":10,"s":1,"i":0},{
"key":"C","x":1,"y":0,"s":1,"i":0},{
"key":"C","x":1,"y":1,"s":1,"i":0},{
"key":"CJ","x":1,"y":2,"s":1,"i":0},{
"key":"C","x":1,"y":3,"s":1,"i":0},{
"key":"C","x":1,"y":4,"s":1,"i":0},{
"key":"C","x":1,"y":5,"s":1,"i":0},{
"key":"C","x":1,"y":6,"s":1,"i":0},{
"key":"CJ","x":1,"y":7,"s":1,"i":0},{
"key":"C","x":1,"y":8,"s":1,"i":0},{
"key":"C","x":1,"y":9,"s":1,"i":0},{
"key":"D","x":2,"y":2,"s":1,"i":0},{
"key":"D","x":2,"y":3,"s":1,"i":0},{
"key":"D","x":2,"y":4,"s":1,"i":0},{
"key":"D","x":2,"y":6,"s":1,"i":0},{
"key":"D","x":2,"y":7,"s":1,"i":0},{
"key":"D","x":2,"y":8,"s":1,"i":0},{
"key":"C","x":3,"y":0,"s":1,"i":0},{
"key":"C","x":3,"y":1,"s":1,"i":0},{
"key":"D","x":3,"y":2,"s":1,"i":0},{
"key":"D","x":3,"y":3,"s":1,"i":0},{
"key":"A","x":3,"y":4,"s":1,"i":0},{
"key":"A","x":3,"y":5,"s":1,"i":0},{
"key":"D","x":3,"y":6,"s":1,"i":0},{
"key":"D","x":3,"y":7,"s":1,"i":0},{
"key":"C","x":3,"y":8,"s":1,"i":0},{
"key":"C","x":3,"y":9,"s":1,"i":0},{
"key":"C","x":4,"y":0,"s":1,"i":0},{
"key":"CJ","x":4,"y":1,"s":1,"i":0},{
"key":"C","x":4,"y":2,"s":1,"i":0},{
"key":"D","x":4,"y":3,"s":1,"i":0},{
"key":"A","x":4,"y":4,"s":1,"i":0},{
"key":"AJ","x":4,"y":5,"s":1,"i":0},{
"key":"A","x":4,"y":6,"s":1,"i":0},{
"key":"D","x":4,"y":7,"s":1,"i":0},{
"key":"C","x":4,"y":8,"s":1,"i":0},{
"key":"CJ","x":4,"y":9,"s":1,"i":0},{
"key":"C","x":4,"y":10,"s":1,"i":0},{
"key":"C","x":5,"y":0,"s":1,"i":0},{
"key":"C","x":5,"y":1,"s":1,"i":0},{
"key":"D","x":5,"y":2,"s":1,"i":0},{
"key":"D","x":5,"y":3,"s":1,"i":0},{
"key":"A","x":5,"y":4,"s":1,"i":0},{
"key":"A","x":5,"y":5,"s":1,"i":0},{
"key":"D","x":5,"y":6,"s":1,"i":0},{
"key":"D","x":5,"y":7,"s":1,"i":0},{
"key":"C","x":5,"y":8,"s":1,"i":0},{
"key":"C","x":5,"y":9,"s":1,"i":0},{
"key":"D","x":6,"y":2,"s":1,"i":0},{
"key":"DJ","x":6,"y":3,"s":1,"i":0},{
"key":"D","x":6,"y":4,"s":1,"i":0},{
"key":"D","x":6,"y":6,"s":1,"i":0},{
"key":"DJ","x":6,"y":7,"s":1,"i":0},{
"key":"D","x":6,"y":8,"s":1,"i":0},{
"key":"D","x":7,"y":2,"s":1,"i":0},{
"key":"D","x":7,"y":3,"s":1,"i":0},{
"key":"C","x":7,"y":4,"s":1,"i":0},{
"key":"C","x":7,"y":5,"s":1,"i":0},{
"key":"D","x":7,"y":6,"s":1,"i":0},{
"key":"D","x":7,"y":7,"s":1,"i":0},{
"key":"C","x":8,"y":0,"s":1,"i":0},{
"key":"C","x":8,"y":1,"s":1,"i":0},{
"key":"C","x":8,"y":2,"s":1,"i":0},{
"key":"C","x":8,"y":3,"s":1,"i":0},{
"key":"C","x":8,"y":4,"s":1,"i":0},{
"key":"C","x":8,"y":5,"s":1,"i":0},{
"key":"C","x":8,"y":6,"s":1,"i":0},{
"key":"C","x":8,"y":7,"s":1,"i":0},{
"key":"C","x":8,"y":8,"s":1,"i":0},{
"key":"C","x":8,"y":9,"s":1,"i":0},{
"key":"C","x":8,"y":10,"s":1,"i":0}],"sub
":[],"down
":[],"jysub

":[]}