{
"BackCround":{
"backCround_type":1,"bottom_type":2,"skill_type":0},"level":678,"mode":1,"LevelType":{
"Key":"@","Type":1,"Number":3},"Star":{
"star1":120,"star2":33333,"star3":40000},"Gang":{
"Gang1":0,"Gang2":0,"Gang3":1,"Gang4":0,"Gang5":1},"BallNumber":27,"TimeLimit":0,"ObjChance":[{
"Key":"C","P":4},{
"Key":"A","P":4},{
"Key":"B","P":4},{
"Key":"E","P":4}],"top":[],"bubble
":[{
"key":"C1","x":0,"y":1,"s":1,"i":0},{
"key":"C1","x":0,"y":2,"s":1,"i":0},{
"key":"C1","x":0,"y":3,"s":1,"i":0},{
"key":"EJ","x":0,"y":4,"s":1,"i":0},{
"key":"C1","x":0,"y":5,"s":1,"i":0},{
"key":"C1","x":0,"y":6,"s":1,"i":0},{
"key":"BJ","x":0,"y":7,"s":1,"i":0},{
"key":"C1","x":1,"y":1,"s":1,"i":0},{
"key":"AJ","x":1,"y":2,"s":1,"i":0},{
"key":"C1","x":1,"y":3,"s":1,"i":0},{
"key":"C1","x":1,"y":4,"s":1,"i":0},{
"key":"C1","x":1,"y":5,"s":1,"i":0},{
"key":"C1","x":1,"y":6,"s":1,"i":0},{
"key":"@","x":1,"y":7,"s":1,"i":0},{
"key":"C1","x":2,"y":2,"s":1,"i":0},{
"key":"C1","x":2,"y":3,"s":1,"i":0},{
"key":"C1","x":2,"y":4,"s":1,"i":0},{
"key":"C1","x":2,"y":5,"s":1,"i":0},{
"key":"C1","x":2,"y":6,"s":1,"i":0},{
"key":"C","x":2,"y":8,"s":1,"i":0},{
"key":"C1","x":3,"y":2,"s":1,"i":0},{
"key":"C1","x":3,"y":3,"s":1,"i":0},{
"key":"C1","x":3,"y":4,"s":1,"i":0},{
"key":"C1","x":3,"y":5,"s":1,"i":0},{
"key":"C","x":3,"y":6,"s":1,"i":0},{
"key":"C","x":3,"y":7,"s":1,"i":0},{
"key":"@","x":3,"y":8,"s":1,"i":0},{
"key":"C1","x":4,"y":3,"s":1,"i":0},{
"key":"C1","x":4,"y":4,"s":1,"i":0},{
"key":"C1","x":4,"y":5,"s":1,"i":0},{
"key":"@","x":4,"y":7,"s":1,"i":0},{
"key":"C1","x":4,"y":8,"s":1,"i":0},{
"key":"@","x":4,"y":9,"s":1,"i":0},{
"key":"H","x":5,"y":0,"s":1,"i":0},{
"key":"H","x":5,"y":1,"s":1,"i":0},{
"key":"H","x":5,"y":2,"s":1,"i":0},{
"key":"H","x":5,"y":3,"s":1,"i":0},{
"key":"H","x":5,"y":4,"s":1,"i":0},{
"key":"H","x":5,"y":5,"s":1,"i":0},{
"key":"@","x":5,"y":6,"s":1,"i":0},{
"key":"C1","x":5,"y":7,"s":1,"i":0},{
"key":"C1","x":5,"y":8,"s":1,"i":0},{
"key":"@","x":5,"y":9,"s":1,"i":0},{
"key":"GR","x":6,"y":3,"s":1,"i":0},{
"key":"@","x":6,"y":4,"s":1,"i":0},{
"key":"@","x":6,"y":6,"s":1,"i":0},{
"key":"@","x":6,"y":7,"s":1,"i":0},{
"key":"C1","x":6,"y":8,"s":1,"i":0},{
"key":"@","x":6,"y":9,"s":1,"i":0},{
"key":"@","x":7,"y":2,"s":1,"i":0},{
"key":"@","x":7,"y":3,"s":1,"i":0},{
"key":"@","x":7,"y":4,"s":1,"i":0},{
"key":"@","x":7,"y":5,"s":1,"i":0},{
"key":"@","x":7,"y":6,"s":1,"i":0},{
"key":"@","x":7,"y":7,"s":1,"i":0},{
"key":"@","x":7,"y":8,"s":1,"i":0},{
"key":"@","x":8,"y":2,"s":1,"i":0},{
"key":"O","x":8,"y":3,"s":1,"i":0},{
"key":"@","x":8,"y":4,"s":1,"i":0},{
"key":"@","x":8,"y":6,"s":1,"i":0},{
"key":"@","x":8,"y":7,"s":1,"i":0},{
"key":"@","x":8,"y":8,"s":1,"i":0},{
"key":"@","x":9,"y":1,"s":1,"i":0},{
"key":"@","x":9,"y":2,"s":1,"i":0},{
"key":"@","x":9,"y":3,"s":1,"i":0},{
"key":"@","x":9,"y":4,"s":1,"i":0},{
"key":"@","x":9,"y":5,"s":1,"i":0},{
"key":"@","x":9,"y":6,"s":1,"i":0},{
"key":"@","x":9,"y":7,"s":1,"i":0},{
"key":"@","x":10,"y":1,"s":1,"i":0},{
"key":"@","x":10,"y":2,"s":1,"i":0},{
"key":"C","x":10,"y":3,"s":1,"i":0},{
"key":"@","x":10,"y":4,"s":1,"i":0},{
"key":"@","x":10,"y":5,"s":1,"i":0},{
"key":"@","x":10,"y":7,"s":1,"i":0},{
"key":"@","x":11,"y":0,"s":1,"i":0},{
"key":"@","x":11,"y":1,"s":1,"i":0},{
"key":"C","x":11,"y":3,"s":1,"i":0},{
"key":"H","x":11,"y":4,"s":1,"i":0},{
"key":"H","x":11,"y":5,"s":1,"i":0},{
"key":"H","x":11,"y":6,"s":1,"i":0},{
"key":"H","x":11,"y":7,"s":1,"i":0},{
"key":"H","x":11,"y":8,"s":1,"i":0},{
"key":"H","x":11,"y":9,"s":1,"i":0},{
"key":"@","x":12,"y":1,"s":1,"i":0},{
"key":"C","x":12,"y":3,"s":1,"i":0},{
"key":"B","x":12,"y":4,"s":1,"i":0},{
"key":"@","x":12,"y":5,"s":1,"i":0},{
"key":"@","x":12,"y":6,"s":1,"i":0},{
"key":"@","x":12,"y":7,"s":1,"i":0},{
"key":"A","x":13,"y":1,"s":1,"i":0},{
"key":"A","x":13,"y":2,"s":1,"i":0},{
"key":"B","x":13,"y":3,"s":1,"i":0},{
"key":"@","x":13,"y":4,"s":1,"i":0},{
"key":"@","x":13,"y":5,"s":1,"i":0},{
"key":"C","x":13,"y":7,"s":1,"i":0},{
"key":"A","x":14,"y":2,"s":1,"i":0},{
"key":"@","x":14,"y":4,"s":1,"i":0},{
"key":"@","x":14,"y":5,"s":1,"i":0},{
"key":"L","x":14,"y":6,"s":1,"i":0},{
"key":"C","x":14,"y":7,"s":1,"i":0},{
"key":"@","x":14,"y":8,"s":1,"i":0},{
"key":"E","x":15,"y":2,"s":1,"i":0},{
"key":"@","x":15,"y":3,"s":1,"i":0},{
"key":"A","x":15,"y":5,"s":1,"i":0},{
"key":"A","x":15,"y":6,"s":1,"i":0},{
"key":"C","x":15,"y":7,"s":1,"i":0},{
"key":"@","x":15,"y":8,"s":1,"i":0},{
"key":"E","x":16,"y":3,"s":1,"i":0},{
"key":"E","x":16,"y":4,"s":1,"i":0},{
"key":"@","x":16,"y":5,"s":1,"i":0},{
"key":"A","x":16,"y":6,"s":1,"i":0},{
"key":"@","x":16,"y":7,"s":1,"i":0},{
"key":"B","x":16,"y":8,"s":1,"i":0},{
"key":"@","x":16,"y":9,"s":1,"i":0},{
"key":"H","x":17,"y":0,"s":1,"i":0},{
"key":"H","x":17,"y":1,"s":1,"i":0},{
"key":"H","x":17,"y":2,"s":1,"i":0},{
"key":"H","x":17,"y":3,"s":1,"i":0},{
"key":"H","x":17,"y":4,"s":1,"i":0},{
"key":"H","x":17,"y":5,"s":1,"i":0},{
"key":"E","x":17,"y":6,"s":1,"i":0},{
"key":"E","x":17,"y":7,"s":1,"i":0},{
"key":"B","x":17,"y":8,"s":1,"i":0},{
"key":"B","x":17,"y":9,"s":1,"i":0},{
"key":"C","x":18,"y":3,"s":1,"i":0},{
"key":"C","x":18,"y":4,"s":1,"i":0},{
"key":"A","x":18,"y":5,"s":1,"i":0},{
"key":"E","x":18,"y":6,"s":1,"i":0},{
"key":"B","x":18,"y":7,"s":1,"i":0},{
"key":"C","x":18,"y":9,"s":1,"i":0},{
"key":"C","x":19,"y":2,"s":1,"i":0},{
"key":"B","x":19,"y":3,"s":1,"i":0},{
"key":"A","x":19,"y":5,"s":1,"i":0},{
"key":"B","x":19,"y":6,"s":1,"i":0},{
"key":"@","x":19,"y":7,"s":1,"i":0},{
"key":"C","x":19,"y":8,"s":1,"i":0},{
"key":"A","x":20,"y":2,"s":1,"i":0},{
"key":"E","x":20,"y":3,"s":1,"i":0},{
"key":"C","x":20,"y":4,"s":1,"i":0},{
"key":"A","x":20,"y":5,"s":1,"i":0},{
"key":"C","x":20,"y":6,"s":1,"i":0},{
"key":"A","x":20,"y":7,"s":1,"i":0},{
"key":"A","x":20,"y":8,"s":1,"i":0},{
"key":"A","x":21,"y":1,"s":1,"i":0},{
"key":"@","x":21,"y":2,"s":1,"i":0},{
"key":"E","x":21,"y":3,"s":1,"i":0},{
"key":"C","x":21,"y":4,"s":1,"i":0},{
"key":"E","x":21,"y":5,"s":1,"i":0},{
"key":"A","x":21,"y":7,"s":1,"i":0},{
"key":"E","x":22,"y":1,"s":1,"i":0},{
"key":"A","x":22,"y":2,"s":1,"i":0},{
"key":"@","x":22,"y":3,"s":1,"i":0},{
"key":"RS","x":22,"y":5,"s":1,"i":0},{
"key":"B","x":22,"y":6,"s":1,"i":0},{
"key":"@","x":22,"y":7,"s":1,"i":0},{
"key":"E","x":23,"y":0,"s":1,"i":0},{
"key":"@","x":23,"y":1,"s":1,"i":0},{
"key":"C","x":23,"y":2,"s":1,"i":0},{
"key":"C","x":23,"y":3,"s":1,"i":0},{
"key":"H","x":23,"y":4,"s":1,"i":0},{
"key":"H","x":23,"y":5,"s":1,"i":0},{
"key":"H","x":23,"y":6,"s":1,"i":0},{
"key":"H","x":23,"y":7,"s":1,"i":0},{
"key":"H","x":23,"y":8,"s":1,"i":0},{
"key":"H","x":23,"y":9,"s":1,"i":0},{
"key":"@","x":24,"y":1,"s":1,"i":0},{
"key":"@","x":24,"y":2,"s":1,"i":0},{
"key":"E","x":24,"y":3,"s":1,"i":0},{
"key":"C","x":24,"y":4,"s":1,"i":0},{
"key":"A","x":24,"y":6,"s":1,"i":0},{
"key":"A","x":24,"y":7,"s":1,"i":0},{
"key":"@","x":25,"y":1,"s":1,"i":0},{
"key":"E","x":25,"y":2,"s":1,"i":0},{
"key":"@","x":25,"y":4,"s":1,"i":0},{
"key":"@","x":25,"y":5,"s":1,"i":0},{
"key":"@","x":25,"y":6,"s":1,"i":0},{
"key":"A","x":25,"y":7,"s":1,"i":0},{
"key":"B","x":26,"y":2,"s":1,"i":0},{
"key":"B","x":26,"y":3,"s":1,"i":0},{
"key":"@","x":26,"y":4,"s":1,"i":0},{
"key":"@","x":26,"y":5,"s":1,"i":0},{
"key":"@","x":26,"y":7,"s":1,"i":0},{
"key":"C","x":26,"y":8,"s":1,"i":0},{
"key":"B","x":27,"y":2,"s":1,"i":0},{
"key":"@","x":27,"y":3,"s":1,"i":0},{
"key":"@","x":27,"y":4,"s":1,"i":0},{
"key":"@","x":27,"y":5,"s":1,"i":0},{
"key":"@","x":27,"y":6,"s":1,"i":0},{
"key":"C","x":27,"y":7,"s":1,"i":0},{
"key":"C","x":27,"y":8,"s":1,"i":0}],"sub
":[{
"key":"S","x":2,"y":8,"s":0,"i":0},{
"key":"S","x":3,"y":7,"s":0,"i":0},{
"key":"S","x":3,"y":8,"s":0,"i":0},{
"key":"S","x":4,"y":7,"s":0,"i":0},{
"key":"S","x":4,"y":9,"s":0,"i":0},{
"key":"S","x":5,"y":6,"s":0,"i":0},{
"key":"S","x":5,"y":9,"s":0,"i":0},{
"key":"S","x":6,"y":7,"s":0,"i":0},{
"key":"S","x":6,"y":9,"s":0,"i":0},{
"key":"S","x":7,"y":7,"s":0,"i":0},{
"key":"S","x":7,"y":8,"s":0,"i":0},{
"key":"S","x":8,"y":2,"s":0,"i":0},{
"key":"S","x":8,"y":8,"s":0,"i":0},{
"key":"S","x":9,"y":1,"s":0,"i":0},{
"key":"S","x":9,"y":2,"s":0,"i":0},{
"key":"S","x":10,"y":1,"s":0,"i":0},{
"key":"S","x":10,"y":3,"s":0,"i":0},{
"key":"S","x":11,"y":0,"s":0,"i":0},{
"key":"S","x":11,"y":3,"s":0,"i":0},{
"key":"S","x":12,"y":1,"s":0,"i":0},{
"key":"S","x":12,"y":3,"s":0,"i":0},{
"key":"S","x":13,"y":1,"s":0,"i":0},{
"key":"S","x":13,"y":2,"s":0,"i":0},{
"key":"S","x":14,"y":2,"s":0,"i":0},{
"key":"S","x":14,"y":8,"s":0,"i":0},{
"key":"S","x":15,"y":7,"s":0,"i":0},{
"key":"S","x":15,"y":8,"s":0,"i":0},{
"key":"S","x":16,"y":7,"s":0,"i":0},{
"key":"S","x":16,"y":9,"s":0,"i":0},{
"key":"S","x":17,"y":6,"s":0,"i":0},{
"key":"S","x":17,"y":9,"s":0,"i":0},{
"key":"S","x":18,"y":7,"s":0,"i":0},{
"key":"S","x":18,"y":9,"s":0,"i":0},{
"key":"S","x":19,"y":7,"s":0,"i":0},{
"key":"S","x":19,"y":8,"s":0,"i":0},{
"key":"S","x":20,"y":2,"s":0,"i":0},{
"key":"S","x":20,"y":8,"s":0,"i":0},{
"key":"S","x":21,"y":1,"s":0,"i":0},{
"key":"S","x":21,"y":2,"s":0,"i":0},{
"key":"S","x":22,"y":1,"s":0,"i":0},{
"key":"S","x":22,"y":3,"s":0,"i":0},{
"key":"S","x":23,"y":0,"s":0,"i":0},{
"key":"S","x":23,"y":3,"s":0,"i":0},{
"key":"S","x":24,"y":1,"s":0,"i":0},{
"key":"S","x":24,"y":3,"s":0,"i":0},{
"key":"S","x":25,"y":1,"s":0,"i":0},{
"key":"S","x":25,"y":2,"s":0,"i":0},{
"key":"S","x":26,"y":2,"s":0,"i":0}]}