{
"BackCround":{
"backCround_type":1,"bottom_type":2,"skill_type":0},"level":333,"mode":1,"LevelType":{
"Key":"@","Type":1,"Number":3},"Star":{
"star1":120,"star2":23540,"star3":41230},"Gang":{
"Gang1":0,"Gang2":0,"Gang3":0,"Gang4":0,"Gang5":1},"ReadyBubble":{
"R1":0,"R2":0,"R3":0,"R4":0},"BallNumber":42,"TimeLimit":0,"ObjChance":[{
"Key":"C","P":5},{
"Key":"A","P":5},{
"Key":"B","P":5},{
"Key":"E","P":5},{
"Key":"D","P":5}],"top":[],"bubble
":[{
"key":"E","x":0,"y":1,"s":1,"i":0},{
"key":"A","x":0,"y":2,"s":1,"i":0},{
"key":"DJ","x":0,"y":4,"s":1,"i":0},{
"key":"D","x":0,"y":5,"s":1,"i":0},{
"key":"K","x":0,"y":7,"s":1,"i":0},{
"key":"CJ","x":0,"y":8,"s":1,"i":0},{
"key":"B","x":0,"y":10,"s":1,"i":0},{
"key":"EJ","x":1,"y":0,"s":1,"i":0},{
"key":"E1","x":1,"y":1,"s":1,"i":0},{
"key":"E","x":1,"y":2,"s":1,"i":0},{
"key":"A","x":1,"y":3,"s":1,"i":0},{
"key":"K","x":1,"y":4,"s":1,"i":0},{
"key":"K","x":1,"y":5,"s":1,"i":0},{
"key":"K","x":1,"y":6,"s":1,"i":0},{
"key":"C","x":1,"y":7,"s":1,"i":0},{
"key":"F","x":1,"y":8,"s":1,"i":0},{
"key":"B","x":1,"y":9,"s":1,"i":0},{
"key":"H","x":2,"y":0,"s":1,"i":0},{
"key":"H","x":2,"y":1,"s":1,"i":0},{
"key":"H","x":2,"y":2,"s":1,"i":0},{
"key":"H","x":2,"y":4,"s":1,"i":0},{
"key":"H","x":2,"y":5,"s":1,"i":0},{
"key":"H","x":2,"y":7,"s":1,"i":0},{
"key":"H","x":2,"y":8,"s":1,"i":0},{
"key":"H","x":2,"y":10,"s":1,"i":0},{
"key":"D1","x":3,"y":0,"s":1,"i":0},{
"key":"D1","x":3,"y":2,"s":1,"i":0},{
"key":"D1","x":3,"y":3,"s":1,"i":0},{
"key":"D1","x":3,"y":5,"s":1,"i":0},{
"key":"D1","x":3,"y":6,"s":1,"i":0},{
"key":"D1","x":3,"y":8,"s":1,"i":0},{
"key":"D1","x":3,"y":9,"s":1,"i":0},{
"key":"D1","x":4,"y":0,"s":1,"i":0},{
"key":"D1","x":4,"y":1,"s":1,"i":0},{
"key":"D1","x":4,"y":2,"s":1,"i":0},{
"key":"D1","x":4,"y":3,"s":1,"i":0},{
"key":"D1","x":4,"y":4,"s":1,"i":0},{
"key":"D1","x":4,"y":5,"s":1,"i":0},{
"key":"D1","x":4,"y":6,"s":1,"i":0},{
"key":"D1","x":4,"y":7,"s":1,"i":0},{
"key":"D1","x":4,"y":8,"s":1,"i":0},{
"key":"D1","x":4,"y":9,"s":1,"i":0},{
"key":"C1","x":4,"y":10,"s":1,"i":0},{
"key":"D1","x":5,"y":0,"s":1,"i":0},{
"key":"D1","x":5,"y":2,"s":1,"i":0},{
"key":"D1","x":5,"y":3,"s":1,"i":0},{
"key":"D1","x":5,"y":5,"s":1,"i":0},{
"key":"D1","x":5,"y":6,"s":1,"i":0},{
"key":"D1","x":5,"y":8,"s":1,"i":0},{
"key":"C1","x":5,"y":9,"s":1,"i":0},{
"key":"D1","x":6,"y":1,"s":1,"i":0},{
"key":"D1","x":6,"y":2,"s":1,"i":0},{
"key":"D1","x":6,"y":4,"s":1,"i":0},{
"key":"D1","x":6,"y":5,"s":1,"i":0},{
"key":"D1","x":6,"y":7,"s":1,"i":0},{
"key":"D1","x":6,"y":8,"s":1,"i":0},{
"key":"C1","x":6,"y":10,"s":1,"i":0},{
"key":"A","x":7,"y":0,"s":1,"i":0},{
"key":"A","x":7,"y":1,"s":1,"i":0},{
"key":"@","x":7,"y":2,"s":1,"i":0},{
"key":"A","x":7,"y":3,"s":1,"i":0},{
"key":"A","x":7,"y":4,"s":1,"i":0},{
"key":"A","x":7,"y":5,"s":1,"i":0},{
"key":"D1","x":7,"y":6,"s":1,"i":0},{
"key":"D1","x":7,"y":7,"s":1,"i":0},{
"key":"@","x":7,"y":8,"s":1,"i":0},{
"key":"@","x":8,"y":1,"s":1,"i":0},{
"key":"@","x":8,"y":2,"s":1,"i":0},{
"key":"@","x":8,"y":4,"s":1,"i":0},{
"key":"K","x":8,"y":5,"s":1,"i":0},{
"key":"D1","x":8,"y":7,"s":1,"i":0},{
"key":"@","x":8,"y":8,"s":1,"i":0},{
"key":"@","x":8,"y":10,"s":1,"i":0},{
"key":"@","x":9,"y":0,"s":1,"i":0},{
"key":"L","x":9,"y":2,"s":1,"i":0},{
"key":"@","x":9,"y":3,"s":1,"i":0},{
"key":"K","x":9,"y":5,"s":1,"i":0},{
"key":"D1","x":9,"y":6,"s":1,"i":0},{
"key":"@","x":9,"y":8,"s":1,"i":0},{
"key":"@","x":9,"y":9,"s":1,"i":0},{
"key":"F","x":10,"y":0,"s":1,"i":0},{
"key":"F","x":10,"y":1,"s":1,"i":0},{
"key":"F","x":10,"y":2,"s":1,"i":0},{
"key":"F","x":10,"y":3,"s":1,"i":0},{
"key":"F","x":10,"y":4,"s":1,"i":0},{
"key":"F","x":10,"y":5,"s":1,"i":0},{
"key":"B","x":10,"y":6,"s":1,"i":0},{
"key":"F","x":10,"y":7,"s":1,"i":0},{
"key":"O","x":10,"y":8,"s":1,"i":0},{
"key":"@","x":10,"y":9,"s":1,"i":0},{
"key":"@","x":10,"y":10,"s":1,"i":0},{
"key":"A","x":11,"y":0,"s":1,"i":0},{
"key":"A","x":11,"y":2,"s":1,"i":0},{
"key":"D","x":11,"y":3,"s":1,"i":0},{
"key":"D","x":11,"y":5,"s":1,"i":0},{
"key":"B","x":11,"y":6,"s":1,"i":0},{
"key":"@","x":11,"y":8,"s":1,"i":0},{
"key":"@","x":11,"y":9,"s":1,"i":0},{
"key":"F","x":12,"y":1,"s":1,"i":0},{
"key":"F","x":12,"y":2,"s":1,"i":0},{
"key":"@","x":12,"y":4,"s":1,"i":0},{
"key":"@","x":12,"y":5,"s":1,"i":0},{
"key":"F","x":12,"y":7,"s":1,"i":0},{
"key":"C","x":12,"y":8,"s":1,"i":0},{
"key":"@","x":12,"y":10,"s":1,"i":0},{
"key":"F","x":13,"y":0,"s":1,"i":0},{
"key":"N","x":13,"y":1,"s":1,"i":0},{
"key":"K","x":13,"y":2,"s":1,"i":0},{
"key":"@","x":13,"y":3,"s":1,"i":0},{
"key":"N","x":13,"y":4,"s":1,"i":0},{
"key":"@","x":13,"y":5,"s":1,"i":0},{
"key":"F","x":13,"y":6,"s":1,"i":0},{
"key":"O","x":13,"y":7,"s":1,"i":0},{
"key":"F","x":13,"y":8,"s":1,"i":0},{
"key":"C","x":13,"y":9,"s":1,"i":0},{
"key":"F","x":14,"y":1,"s":1,"i":0},{
"key":"K","x":14,"y":2,"s":1,"i":0},{
"key":"E","x":14,"y":4,"s":1,"i":0},{
"key":"@","x":14,"y":5,"s":1,"i":0},{
"key":"H","x":14,"y":7,"s":1,"i":0},{
"key":"H","x":14,"y":8,"s":1,"i":0},{
"key":"C","x":14,"y":10,"s":1,"i":0},{
"key":"E","x":15,"y":2,"s":1,"i":0},{
"key":"E","x":15,"y":3,"s":1,"i":0},{
"key":"@","x":15,"y":6,"s":1,"i":0},{
"key":"A","x":15,"y":7,"s":1,"i":0},{
"key":"M","x":15,"y":9,"s":1,"i":0},{
"key":"D1","x":16,"y":2,"s":1,"i":0},{
"key":"@","x":16,"y":3,"s":1,"i":0},{
"key":"@","x":16,"y":5,"s":1,"i":0},{
"key":"A","x":16,"y":7,"s":1,"i":0},{
"key":"@","x":16,"y":8,"s":1,"i":0},{
"key":"D1","x":17,"y":1,"s":1,"i":0},{
"key":"@","x":17,"y":2,"s":1,"i":0},{
"key":"@","x":17,"y":4,"s":1,"i":0},{
"key":"@","x":17,"y":5,"s":1,"i":0},{
"key":"F","x":17,"y":7,"s":1,"i":0},{
"key":"@","x":17,"y":8,"s":1,"i":0},{
"key":"D1","x":18,"y":1,"s":1,"i":0},{
"key":"@","x":18,"y":2,"s":1,"i":0},{
"key":"@","x":18,"y":4,"s":1,"i":0},{
"key":"@","x":18,"y":6,"s":1,"i":0},{
"key":"F","x":18,"y":8,"s":1,"i":0},{
"key":"@","x":18,"y":9,"s":1,"i":0},{
"key":"D1","x":19,"y":0,"s":1,"i":0},{
"key":"B","x":19,"y":1,"s":1,"i":0},{
"key":"F","x":19,"y":3,"s":1,"i":0},{
"key":"@","x":19,"y":4,"s":1,"i":0},{
"key":"B","x":19,"y":5,"s":1,"i":0},{
"key":"I","x":19,"y":6,"s":1,"i":0},{
"key":"F","x":19,"y":8,"s":1,"i":0},{
"key":"@","x":19,"y":9,"s":1,"i":0},{
"key":"D1","x":20,"y":0,"s":1,"i":0},{
"key":"@","x":20,"y":1,"s":1,"i":0},{
"key":"A1","x":20,"y":2,"s":1,"i":0},{
"key":"A","x":20,"y":3,"s":1,"i":0},{
"key":"L","x":20,"y":5,"s":1,"i":0},{
"key":"K","x":20,"y":7,"s":1,"i":0},{
"key":"K","x":20,"y":8,"s":1,"i":0},{
"key":"F","x":20,"y":9,"s":1,"i":0},{
"key":"C","x":20,"y":10,"s":1,"i":0},{
"key":"D1","x":21,"y":0,"s":1,"i":0},{
"key":"B","x":21,"y":1,"s":1,"i":0},{
"key":"F","x":21,"y":3,"s":1,"i":0},{
"key":"E","x":21,"y":4,"s":1,"i":0},{
"key":"B","x":21,"y":5,"s":1,"i":0},{
"key":"I","x":21,"y":6,"s":1,"i":0},{
"key":"F","x":21,"y":8,"s":1,"i":0},{
"key":"D1","x":21,"y":9,"s":1,"i":0},{
"key":"D1","x":22,"y":1,"s":1,"i":0},{
"key":"B","x":22,"y":2,"s":1,"i":0},{
"key":"A","x":22,"y":4,"s":1,"i":0},{
"key":"C","x":22,"y":6,"s":1,"i":0},{
"key":"F","x":22,"y":8,"s":1,"i":0},{
"key":"D","x":22,"y":9,"s":1,"i":0},{
"key":"D1","x":23,"y":1,"s":1,"i":0},{
"key":"E","x":23,"y":2,"s":1,"i":0},{
"key":"A","x":23,"y":4,"s":1,"i":0},{
"key":"C","x":23,"y":5,"s":1,"i":0},{
"key":"F","x":23,"y":7,"s":1,"i":0},{
"key":"C1","x":23,"y":8,"s":1,"i":0},{
"key":"E1","x":24,"y":2,"s":1,"i":0},{
"key":"E1","x":24,"y":3,"s":1,"i":0},{
"key":"@","x":24,"y":5,"s":1,"i":0},{
"key":"F","x":24,"y":7,"s":1,"i":0},{
"key":"D","x":24,"y":8,"s":1,"i":0},{
"key":"@","x":25,"y":0,"s":1,"i":0},{
"key":"E","x":25,"y":1,"s":1,"i":0},{
"key":"B","x":25,"y":2,"s":1,"i":0},{
"key":"E","x":25,"y":3,"s":1,"i":0},{
"key":"H","x":25,"y":4,"s":1,"i":0},{
"key":"H","x":25,"y":5,"s":1,"i":0},{
"key":"G","x":25,"y":6,"s":1,"i":0},{
"key":"@","x":25,"y":7,"s":1,"i":0},{
"key":"K","x":25,"y":8,"s":1,"i":0},{
"key":"@","x":25,"y":9,"s":1,"i":0}],"sub
":[],"down
":[],"jysub

":[]}