{
"BackCround":{
"backCround_type":1,"bottom_type":2,"skill_type":0},"level":802,"mode":1,"LevelType":{
"Key":"@","Type":1,"Number":5},"Star":{
"star1":321,"star2":50000,"star3":150000},"Gang":{
"Gang1":0,"Gang2":1,"Gang3":0,"Gang4":0,"Gang5":0},"ReadyBubble":{
"R1":0,"R2":0,"R3":0,"R4":0},"BallNumber":30,"TimeLimit":0,"ObjChance":[{
"Key":"C","P":1},{
"Key":"A","P":1},{
"Key":"B","P":1},{
"Key":"E","P":1},{
"Key":"D","P":1}],"top":[],"bubble
":[{
"key":"I","x":0,"y":0,"s":1,"i":0},{
"key":"I","x":0,"y":1,"s":1,"i":0},{
"key":"I","x":0,"y":2,"s":1,"i":0},{
"key":"D1","x":0,"y":4,"s":1,"i":0},{
"key":"DJ","x":0,"y":5,"s":1,"i":0},{
"key":"@","x":0,"y":6,"s":1,"i":0},{
"key":"B1","x":1,"y":0,"s":1,"i":0},{
"key":"@","x":1,"y":1,"s":1,"i":0},{
"key":"I","x":1,"y":2,"s":1,"i":0},{
"key":"@","x":1,"y":4,"s":1,"i":0},{
"key":"@","x":1,"y":5,"s":1,"i":0},{
"key":"@","x":1,"y":6,"s":1,"i":0},{
"key":"CJ","x":2,"y":0,"s":1,"i":0},{
"key":"@","x":2,"y":1,"s":1,"i":0},{
"key":"I","x":2,"y":2,"s":1,"i":0},{
"key":"@","x":2,"y":4,"s":1,"i":0},{
"key":"@","x":2,"y":5,"s":1,"i":0},{
"key":"@","x":2,"y":6,"s":1,"i":0},{
"key":"@","x":2,"y":7,"s":1,"i":0},{
"key":"E1","x":3,"y":0,"s":1,"i":0},{
"key":"@","x":3,"y":1,"s":1,"i":0},{
"key":"I","x":3,"y":2,"s":1,"i":0},{
"key":"@","x":3,"y":4,"s":1,"i":0},{
"key":"C1","x":3,"y":5,"s":1,"i":0},{
"key":"C1","x":3,"y":6,"s":1,"i":0},{
"key":"@","x":3,"y":7,"s":1,"i":0},{
"key":"@","x":3,"y":8,"s":1,"i":0},{
"key":"J","x":3,"y":9,"s":1,"i":0},{
"key":"AJ","x":4,"y":0,"s":1,"i":0},{
"key":"@","x":4,"y":1,"s":1,"i":0},{
"key":"I","x":4,"y":2,"s":1,"i":0},{
"key":"@","x":4,"y":4,"s":1,"i":0},{
"key":"F","x":4,"y":5,"s":1,"i":0},{
"key":"C1","x":4,"y":6,"s":1,"i":0},{
"key":"EJ","x":4,"y":7,"s":1,"i":0},{
"key":"@","x":4,"y":8,"s":1,"i":0},{
"key":"F","x":4,"y":9,"s":1,"i":0},{
"key":"@","x":4,"y":10,"s":1,"i":0},{
"key":"@","x":5,"y":0,"s":1,"i":0},{
"key":"@","x":5,"y":1,"s":1,"i":0},{
"key":"I","x":5,"y":2,"s":1,"i":0},{
"key":"@","x":5,"y":4,"s":1,"i":0},{
"key":"A1","x":5,"y":5,"s":1,"i":0},{
"key":"A1","x":5,"y":6,"s":1,"i":0},{
"key":"B1","x":5,"y":7,"s":1,"i":0},{
"key":"B1","x":5,"y":8,"s":1,"i":0},{
"key":"@","x":5,"y":9,"s":1,"i":0},{
"key":"@","x":6,"y":4,"s":1,"i":0},{
"key":"F","x":6,"y":5,"s":1,"i":0},{
"key":"A1","x":6,"y":6,"s":1,"i":0},{
"key":"F","x":6,"y":7,"s":1,"i":0},{
"key":"B1","x":6,"y":8,"s":1,"i":0},{
"key":"F","x":6,"y":9,"s":1,"i":0},{
"key":"@","x":6,"y":10,"s":1,"i":0},{
"key":"@","x":7,"y":4,"s":1,"i":0},{
"key":"E1","x":7,"y":5,"s":1,"i":0},{
"key":"E1","x":7,"y":6,"s":1,"i":0},{
"key":"D1","x":7,"y":7,"s":1,"i":0},{
"key":"D1","x":7,"y":8,"s":1,"i":0},{
"key":"@","x":7,"y":9,"s":1,"i":0},{
"key":"@","x":8,"y":0,"s":1,"i":0},{
"key":"@","x":8,"y":1,"s":1,"i":0},{
"key":"@","x":8,"y":2,"s":1,"i":0},{
"key":"@","x":8,"y":3,"s":1,"i":0},{
"key":"@","x":8,"y":4,"s":1,"i":0},{
"key":"F","x":8,"y":5,"s":1,"i":0},{
"key":"E1","x":8,"y":6,"s":1,"i":0},{
"key":"F","x":8,"y":7,"s":1,"i":0},{
"key":"D1","x":8,"y":8,"s":1,"i":0},{
"key":"F","x":8,"y":9,"s":1,"i":0},{
"key":"@","x":8,"y":10,"s":1,"i":0},{
"key":"@","x":9,"y":0,"s":1,"i":0},{
"key":"C","x":9,"y":1,"s":1,"i":0},{
"key":"E","x":9,"y":2,"s":1,"i":0},{
"key":"D","x":9,"y":3,"s":1,"i":0},{
"key":"@","x":9,"y":4,"s":1,"i":0},{
"key":"@","x":9,"y":5,"s":1,"i":0},{
"key":"@","x":9,"y":6,"s":1,"i":0},{
"key":"@","x":9,"y":7,"s":1,"i":0},{
"key":"A","x":9,"y":8,"s":1,"i":0},{
"key":"BJ","x":9,"y":9,"s":1,"i":0},{
"key":"@","x":10,"y":0,"s":1,"i":0},{
"key":"B","x":10,"y":1,"s":1,"i":0},{
"key":"@","x":10,"y":2,"s":1,"i":0},{
"key":"RS","x":10,"y":3,"s":1,"i":0},{
"key":"@","x":10,"y":4,"s":1,"i":0},{
"key":"B","x":10,"y":5,"s":1,"i":0},{
"key":"A","x":10,"y":6,"s":1,"i":0},{
"key":"RS","x":10,"y":7,"s":1,"i":0},{
"key":"@","x":10,"y":8,"s":1,"i":0},{
"key":"C","x":10,"y":9,"s":1,"i":0},{
"key":"E","x":10,"y":10,"s":1,"i":0},{
"key":"D","x":11,"y":0,"s":1,"i":0},{
"key":"A","x":11,"y":1,"s":1,"i":0},{
"key":"C1","x":11,"y":2,"s":1,"i":0},{
"key":"@","x":11,"y":3,"s":1,"i":0},{
"key":"C","x":11,"y":4,"s":1,"i":0},{
"key":"E","x":11,"y":5,"s":1,"i":0},{
"key":"A1","x":11,"y":6,"s":1,"i":0},{
"key":"D","x":11,"y":7,"s":1,"i":0},{
"key":"B","x":11,"y":8,"s":1,"i":0},{
"key":"@","x":11,"y":9,"s":1,"i":0},{
"key":"@","x":12,"y":0,"s":1,"i":0},{
"key":"@","x":12,"y":1,"s":1,"i":0},{
"key":"@","x":12,"y":2,"s":1,"i":0},{
"key":"@","x":12,"y":3,"s":1,"i":0},{
"key":"@","x":12,"y":4,"s":1,"i":0},{
"key":"@","x":12,"y":5,"s":1,"i":0},{
"key":"@","x":12,"y":6,"s":1,"i":0},{
"key":"@","x":12,"y":7,"s":1,"i":0},{
"key":"@","x":12,"y":8,"s":1,"i":0},{
"key":"@","x":12,"y":9,"s":1,"i":0},{
"key":"@","x":12,"y":10,"s":1,"i":0},{
"key":"@","x":13,"y":1,"s":1,"i":0},{
"key":"C","x":13,"y":2,"s":1,"i":0},{
"key":"D","x":13,"y":3,"s":1,"i":0},{
"key":"E","x":13,"y":4,"s":1,"i":0},{
"key":"B","x":13,"y":5,"s":1,"i":0},{
"key":"B","x":13,"y":6,"s":1,"i":0},{
"key":"A","x":13,"y":7,"s":1,"i":0},{
"key":"@","x":13,"y":8,"s":1,"i":0},{
"key":"H","x":14,"y":1,"s":1,"i":0},{
"key":"B","x":14,"y":2,"s":1,"i":0},{
"key":"@","x":14,"y":3,"s":1,"i":0},{
"key":"C","x":14,"y":4,"s":1,"i":0},{
"key":"E","x":14,"y":5,"s":1,"i":0},{
"key":"D","x":14,"y":6,"s":1,"i":0},{
"key":"E","x":14,"y":7,"s":1,"i":0},{
"key":"A","x":14,"y":8,"s":1,"i":0},{
"key":"H","x":14,"y":9,"s":1,"i":0},{
"key":"H","x":15,"y":1,"s":1,"i":0},{
"key":"B","x":15,"y":2,"s":1,"i":0},{
"key":"A","x":15,"y":3,"s":1,"i":0},{
"key":"H","x":15,"y":4,"s":1,"i":0},{
"key":"H","x":15,"y":5,"s":1,"i":0},{
"key":"E","x":15,"y":6,"s":1,"i":0},{
"key":"C","x":15,"y":7,"s":1,"i":0},{
"key":"H","x":15,"y":8,"s":1,"i":0},{
"key":"H","x":16,"y":2,"s":1,"i":0},{
"key":"C","x":16,"y":3,"s":1,"i":0},{
"key":"H","x":16,"y":4,"s":1,"i":0},{
"key":"N","x":16,"y":5,"s":1,"i":0},{
"key":"H","x":16,"y":6,"s":1,"i":0},{
"key":"D","x":16,"y":7,"s":1,"i":0},{
"key":"H","x":16,"y":8,"s":1,"i":0},{
"key":"E","x":17,"y":2,"s":1,"i":0},{
"key":"A","x":17,"y":3,"s":1,"i":0},{
"key":"F","x":17,"y":4,"s":1,"i":0},{
"key":"F","x":17,"y":5,"s":1,"i":0},{
"key":"A","x":17,"y":6,"s":1,"i":0},{
"key":"B","x":17,"y":7,"s":1,"i":0},{
"key":"@","x":18,"y":2,"s":1,"i":0},{
"key":"E","x":18,"y":3,"s":1,"i":0},{
"key":"D","x":18,"y":4,"s":1,"i":0},{
"key":"F","x":18,"y":5,"s":1,"i":0},{
"key":"C","x":18,"y":6,"s":1,"i":0},{
"key":"A","x":18,"y":7,"s":1,"i":0},{
"key":"C","x":18,"y":8,"s":1,"i":0},{
"key":"A","x":19,"y":1,"s":1,"i":0},{
"key":"C","x":19,"y":2,"s":1,"i":0},{
"key":"B","x":19,"y":3,"s":1,"i":0},{
"key":"D","x":19,"y":4,"s":1,"i":0},{
"key":"@","x":19,"y":5,"s":1,"i":0},{
"key":"C","x":19,"y":6,"s":1,"i":0},{
"key":"E","x":19,"y":7,"s":1,"i":0},{
"key":"D","x":19,"y":8,"s":1,"i":0},{
"key":"C","x":20,"y":1,"s":1,"i":0},{
"key":"A","x":20,"y":2,"s":1,"i":0},{
"key":"E","x":20,"y":3,"s":1,"i":0},{
"key":"E","x":20,"y":4,"s":1,"i":0},{
"key":"B","x":20,"y":5,"s":1,"i":0},{
"key":"@","x":20,"y":6,"s":1,"i":0},{
"key":"B","x":20,"y":7,"s":1,"i":0},{
"key":"C","x":20,"y":8,"s":1,"i":0},{
"key":"D","x":20,"y":9,"s":1,"i":0}],"sub
":[{
"key":"L","x":12,"y":0,"s":0,"i":0},{
"key":"L","x":12,"y":1,"s":0,"i":0},{
"key":"L","x":12,"y":2,"s":0,"i":0},{
"key":"Suo","x":12,"y":3,"s":0,"i":0},{
"key":"L","x":12,"y":4,"s":0,"i":0},{
"key":"L","x":12,"y":5,"s":0,"i":0},{
"key":"L","x":12,"y":6,"s":0,"i":0},{
"key":"Suo","x":12,"y":7,"s":0,"i":0},{
"key":"L","x":12,"y":8,"s":0,"i":0},{
"key":"L","x":12,"y":9,"s":0,"i":0},{
"key":"L","x":12,"y":10,"s":0,"i":0}]}