{
"BackCround":{
"backCround_type":1,"bottom_type":2,"skill_type":0},"level":699,"mode":1,"LevelType":{
"Key":"@","Type":1,"Number":6},"Star":{
"star1":120,"star2":48888,"star3":53000},"Gang":{
"Gang1":0,"Gang2":1,"Gang3":1,"Gang4":1,"Gang5":0},"ReadyBubble":{
"R1":0,"R2":0,"R3":0,"R4":0},"BallNumber":33,"TimeLimit":0,"ObjChance":[{
"Key":"C","P":4},{
"Key":"A","P":4},{
"Key":"B","P":4}],"top":[],"bubble
":[{
"key":"H","x":0,"y":3,"s":1,"i":0},{
"key":"C1","x":0,"y":4,"s":1,"i":0},{
"key":"BJ","x":0,"y":5,"s":1,"i":0},{
"key":"C1","x":0,"y":6,"s":1,"i":0},{
"key":"H","x":0,"y":7,"s":1,"i":0},{
"key":"C1","x":1,"y":2,"s":1,"i":0},{
"key":"G","x":1,"y":3,"s":1,"i":0},{
"key":"G","x":1,"y":4,"s":1,"i":0},{
"key":"G","x":1,"y":5,"s":1,"i":0},{
"key":"G","x":1,"y":6,"s":1,"i":0},{
"key":"C1","x":1,"y":7,"s":1,"i":0},{
"key":"C","x":2,"y":2,"s":1,"i":0},{
"key":"G","x":2,"y":3,"s":1,"i":0},{
"key":"F","x":2,"y":4,"s":1,"i":0},{
"key":"F","x":2,"y":5,"s":1,"i":0},{
"key":"F","x":2,"y":6,"s":1,"i":0},{
"key":"G","x":2,"y":7,"s":1,"i":0},{
"key":"B","x":2,"y":8,"s":1,"i":0},{
"key":"C1","x":3,"y":1,"s":1,"i":0},{
"key":"G","x":3,"y":2,"s":1,"i":0},{
"key":"F","x":3,"y":3,"s":1,"i":0},{
"key":"A","x":3,"y":4,"s":1,"i":0},{
"key":"C","x":3,"y":5,"s":1,"i":0},{
"key":"F","x":3,"y":6,"s":1,"i":0},{
"key":"G","x":3,"y":7,"s":1,"i":0},{
"key":"C1","x":3,"y":8,"s":1,"i":0},{
"key":"A","x":4,"y":1,"s":1,"i":0},{
"key":"G","x":4,"y":2,"s":1,"i":0},{
"key":"B","x":4,"y":3,"s":1,"i":0},{
"key":"AJ","x":4,"y":4,"s":1,"i":0},{
"key":"H","x":4,"y":5,"s":1,"i":0},{
"key":"CJ","x":4,"y":6,"s":1,"i":0},{
"key":"A","x":4,"y":7,"s":1,"i":0},{
"key":"G","x":4,"y":8,"s":1,"i":0},{
"key":"A","x":4,"y":9,"s":1,"i":0},{
"key":"C1","x":5,"y":1,"s":1,"i":0},{
"key":"G","x":5,"y":2,"s":1,"i":0},{
"key":"B","x":5,"y":3,"s":1,"i":0},{
"key":"H","x":5,"y":4,"s":1,"i":0},{
"key":"H","x":5,"y":5,"s":1,"i":0},{
"key":"A","x":5,"y":6,"s":1,"i":0},{
"key":"G","x":5,"y":7,"s":1,"i":0},{
"key":"C1","x":5,"y":8,"s":1,"i":0},{
"key":"C","x":6,"y":2,"s":1,"i":0},{
"key":"G","x":6,"y":3,"s":1,"i":0},{
"key":"EJ","x":6,"y":4,"s":1,"i":0},{
"key":"EJ","x":6,"y":5,"s":1,"i":0},{
"key":"EJ","x":6,"y":6,"s":1,"i":0},{
"key":"G","x":6,"y":7,"s":1,"i":0},{
"key":"B","x":6,"y":8,"s":1,"i":0},{
"key":"C1","x":7,"y":2,"s":1,"i":0},{
"key":"G","x":7,"y":3,"s":1,"i":0},{
"key":"G","x":7,"y":4,"s":1,"i":0},{
"key":"G","x":7,"y":5,"s":1,"i":0},{
"key":"G","x":7,"y":6,"s":1,"i":0},{
"key":"C1","x":7,"y":7,"s":1,"i":0},{
"key":"B","x":8,"y":3,"s":1,"i":0},{
"key":"C1","x":8,"y":4,"s":1,"i":0},{
"key":"A","x":8,"y":5,"s":1,"i":0},{
"key":"C1","x":8,"y":6,"s":1,"i":0},{
"key":"C","x":8,"y":7,"s":1,"i":0},{
"key":"A","x":10,"y":2,"s":1,"i":0},{
"key":"GR","x":10,"y":3,"s":1,"i":0},{
"key":"A","x":10,"y":4,"s":1,"i":0},{
"key":"B","x":10,"y":5,"s":1,"i":0},{
"key":"B","x":10,"y":6,"s":1,"i":0},{
"key":"GR","x":10,"y":7,"s":1,"i":0},{
"key":"B","x":10,"y":8,"s":1,"i":0},{
"key":"C","x":11,"y":1,"s":1,"i":0},{
"key":"A","x":11,"y":2,"s":1,"i":0},{
"key":"A","x":11,"y":3,"s":1,"i":0},{
"key":"B","x":11,"y":4,"s":1,"i":0},{
"key":"C","x":11,"y":5,"s":1,"i":0},{
"key":"B","x":11,"y":6,"s":1,"i":0},{
"key":"B","x":11,"y":7,"s":1,"i":0},{
"key":"A","x":11,"y":8,"s":1,"i":0},{
"key":"I","x":12,"y":1,"s":1,"i":0},{
"key":"C","x":12,"y":2,"s":1,"i":0},{
"key":"J","x":12,"y":3,"s":1,"i":0},{
"key":"B","x":12,"y":4,"s":1,"i":0},{
"key":"H","x":12,"y":5,"s":1,"i":0},{
"key":"C","x":12,"y":6,"s":1,"i":0},{
"key":"J","x":12,"y":7,"s":1,"i":0},{
"key":"A","x":12,"y":8,"s":1,"i":0},{
"key":"I","x":12,"y":9,"s":1,"i":0},{
"key":"C","x":13,"y":0,"s":1,"i":0},{
"key":"C","x":13,"y":1,"s":1,"i":0},{
"key":"C","x":13,"y":2,"s":1,"i":0},{
"key":"H","x":13,"y":3,"s":1,"i":0},{
"key":"C1","x":13,"y":4,"s":1,"i":0},{
"key":"C1","x":13,"y":5,"s":1,"i":0},{
"key":"H","x":13,"y":6,"s":1,"i":0},{
"key":"A","x":13,"y":7,"s":1,"i":0},{
"key":"A","x":13,"y":8,"s":1,"i":0},{
"key":"A","x":13,"y":9,"s":1,"i":0},{
"key":"I","x":14,"y":1,"s":1,"i":0},{
"key":"I","x":14,"y":2,"s":1,"i":0},{
"key":"A","x":14,"y":3,"s":1,"i":0},{
"key":"@","x":14,"y":4,"s":1,"i":0},{
"key":"A","x":14,"y":5,"s":1,"i":0},{
"key":"@","x":14,"y":6,"s":1,"i":0},{
"key":"C","x":14,"y":7,"s":1,"i":0},{
"key":"I","x":14,"y":8,"s":1,"i":0},{
"key":"I","x":14,"y":9,"s":1,"i":0},{
"key":"A","x":15,"y":1,"s":1,"i":0},{
"key":"G","x":15,"y":2,"s":1,"i":0},{
"key":"A","x":15,"y":3,"s":1,"i":0},{
"key":"B","x":15,"y":4,"s":1,"i":0},{
"key":"B","x":15,"y":5,"s":1,"i":0},{
"key":"C","x":15,"y":6,"s":1,"i":0},{
"key":"G","x":15,"y":7,"s":1,"i":0},{
"key":"C","x":15,"y":8,"s":1,"i":0},{
"key":"A","x":16,"y":2,"s":1,"i":0},{
"key":"A","x":16,"y":3,"s":1,"i":0},{
"key":"H","x":16,"y":4,"s":1,"i":0},{
"key":"B","x":16,"y":5,"s":1,"i":0},{
"key":"H","x":16,"y":6,"s":1,"i":0},{
"key":"C","x":16,"y":7,"s":1,"i":0},{
"key":"C","x":16,"y":8,"s":1,"i":0},{
"key":"@","x":18,"y":1,"s":1,"i":0},{
"key":"@","x":18,"y":2,"s":1,"i":0},{
"key":"@","x":18,"y":3,"s":1,"i":0},{
"key":"@","x":18,"y":7,"s":1,"i":0},{
"key":"@","x":18,"y":8,"s":1,"i":0},{
"key":"@","x":18,"y":9,"s":1,"i":0},{
"key":"@","x":19,"y":0,"s":1,"i":0},{
"key":"J","x":19,"y":1,"s":1,"i":0},{
"key":"@","x":19,"y":2,"s":1,"i":0},{
"key":"@","x":19,"y":3,"s":1,"i":0},{
"key":"H","x":19,"y":4,"s":1,"i":0},{
"key":"H","x":19,"y":5,"s":1,"i":0},{
"key":"@","x":19,"y":6,"s":1,"i":0},{
"key":"@","x":19,"y":7,"s":1,"i":0},{
"key":"J","x":19,"y":8,"s":1,"i":0},{
"key":"@","x":19,"y":9,"s":1,"i":0},{
"key":"C","x":20,"y":0,"s":1,"i":0},{
"key":"C","x":20,"y":1,"s":1,"i":0},{
"key":"C1","x":20,"y":2,"s":1,"i":0},{
"key":"@","x":20,"y":3,"s":1,"i":0},{
"key":"@","x":20,"y":4,"s":1,"i":0},{
"key":"H","x":20,"y":5,"s":1,"i":0},{
"key":"@","x":20,"y":6,"s":1,"i":0},{
"key":"@","x":20,"y":7,"s":1,"i":0},{
"key":"C1","x":20,"y":8,"s":1,"i":0},{
"key":"@","x":20,"y":9,"s":1,"i":0},{
"key":"@","x":20,"y":10,"s":1,"i":0},{
"key":"C","x":21,"y":0,"s":1,"i":0},{
"key":"B","x":21,"y":1,"s":1,"i":0},{
"key":"B","x":21,"y":2,"s":1,"i":0},{
"key":"C","x":21,"y":3,"s":1,"i":0},{
"key":"H","x":21,"y":4,"s":1,"i":0},{
"key":"H","x":21,"y":5,"s":1,"i":0},{
"key":"A","x":21,"y":6,"s":1,"i":0},{
"key":"C","x":21,"y":7,"s":1,"i":0},{
"key":"C","x":21,"y":8,"s":1,"i":0},{
"key":"B","x":21,"y":9,"s":1,"i":0},{
"key":"A","x":22,"y":1,"s":1,"i":0},{
"key":"A","x":22,"y":2,"s":1,"i":0},{
"key":"C","x":22,"y":3,"s":1,"i":0},{
"key":"B","x":22,"y":5,"s":1,"i":0},{
"key":"A","x":22,"y":7,"s":1,"i":0},{
"key":"A","x":22,"y":8,"s":1,"i":0},{
"key":"B","x":22,"y":9,"s":1,"i":0},{
"key":"H","x":23,"y":2,"s":1,"i":0},{
"key":"H","x":23,"y":3,"s":1,"i":0},{
"key":"B","x":23,"y":4,"s":1,"i":0},{
"key":"C","x":23,"y":5,"s":1,"i":0},{
"key":"H","x":23,"y":6,"s":1,"i":0},{
"key":"H","x":23,"y":7,"s":1,"i":0},{
"key":"H","x":24,"y":3,"s":1,"i":0},{
"key":"A","x":24,"y":4,"s":1,"i":0},{
"key":"B","x":24,"y":5,"s":1,"i":0},{
"key":"C","x":24,"y":6,"s":1,"i":0},{
"key":"H","x":24,"y":7,"s":1,"i":0},{
"key":"H","x":25,"y":0,"s":1,"i":0},{
"key":"H","x":25,"y":1,"s":1,"i":0},{
"key":"C","x":25,"y":3,"s":1,"i":0},{
"key":"A","x":25,"y":4,"s":1,"i":0},{
"key":"C","x":25,"y":5,"s":1,"i":0},{
"key":"B","x":25,"y":6,"s":1,"i":0},{
"key":"H","x":25,"y":8,"s":1,"i":0},{
"key":"H","x":25,"y":9,"s":1,"i":0},{
"key":"H","x":26,"y":0,"s":1,"i":0},{
"key":"H","x":26,"y":2,"s":1,"i":0},{
"key":"C","x":26,"y":3,"s":1,"i":0},{
"key":"A","x":26,"y":4,"s":1,"i":0},{
"key":"B","x":26,"y":5,"s":1,"i":0},{
"key":"B","x":26,"y":6,"s":1,"i":0},{
"key":"C","x":26,"y":7,"s":1,"i":0},{
"key":"H","x":26,"y":8,"s":1,"i":0},{
"key":"H","x":26,"y":10,"s":1,"i":0},{
"key":"H","x":27,"y":0,"s":1,"i":0},{
"key":"H","x":27,"y":1,"s":1,"i":0},{
"key":"A","x":27,"y":2,"s":1,"i":0},{
"key":"H","x":27,"y":3,"s":1,"i":0},{
"key":"G","x":27,"y":4,"s":1,"i":0},{
"key":"G","x":27,"y":5,"s":1,"i":0},{
"key":"H","x":27,"y":6,"s":1,"i":0},{
"key":"C","x":27,"y":7,"s":1,"i":0},{
"key":"H","x":27,"y":8,"s":1,"i":0},{
"key":"H","x":27,"y":9,"s":1,"i":0},{
"key":"C","x":28,"y":2,"s":1,"i":0},{
"key":"A","x":28,"y":3,"s":1,"i":0},{
"key":"A","x":28,"y":4,"s":1,"i":0},{
"key":"C","x":28,"y":5,"s":1,"i":0},{
"key":"A","x":28,"y":6,"s":1,"i":0},{
"key":"C","x":28,"y":7,"s":1,"i":0},{
"key":"B","x":28,"y":8,"s":1,"i":0},{
"key":"H","x":29,"y":0,"s":1,"i":0},{
"key":"C","x":29,"y":1,"s":1,"i":0},{
"key":"C","x":29,"y":2,"s":1,"i":0},{
"key":"B","x":29,"y":3,"s":1,"i":0},{
"key":"C","x":29,"y":4,"s":1,"i":0},{
"key":"C","x":29,"y":5,"s":1,"i":0},{
"key":"A","x":29,"y":6,"s":1,"i":0},{
"key":"A","x":29,"y":7,"s":1,"i":0},{
"key":"B","x":29,"y":8,"s":1,"i":0},{
"key":"H","x":29,"y":9,"s":1,"i":0},{
"key":"H","x":30,"y":0,"s":1,"i":0},{
"key":"A","x":30,"y":2,"s":1,"i":0},{
"key":"B","x":30,"y":3,"s":1,"i":0},{
"key":"A","x":30,"y":4,"s":1,"i":0},{
"key":"A","x":30,"y":5,"s":1,"i":0},{
"key":"B","x":30,"y":6,"s":1,"i":0},{
"key":"B","x":30,"y":7,"s":1,"i":0},{
"key":"C","x":30,"y":8,"s":1,"i":0},{
"key":"H","x":30,"y":10,"s":1,"i":0},{
"key":"H","x":31,"y":0,"s":1,"i":0},{
"key":"H","x":31,"y":1,"s":1,"i":0},{
"key":"A","x":31,"y":2,"s":1,"i":0},{
"key":"H","x":31,"y":3,"s":1,"i":0},{
"key":"G","x":31,"y":4,"s":1,"i":0},{
"key":"G","x":31,"y":5,"s":1,"i":0},{
"key":"H","x":31,"y":6,"s":1,"i":0},{
"key":"C","x":31,"y":7,"s":1,"i":0},{
"key":"H","x":31,"y":8,"s":1,"i":0},{
"key":"H","x":31,"y":9,"s":1,"i":0},{
"key":"C","x":32,"y":3,"s":1,"i":0},{
"key":"C","x":32,"y":4,"s":1,"i":0},{
"key":"A","x":32,"y":5,"s":1,"i":0},{
"key":"B","x":32,"y":6,"s":1,"i":0},{
"key":"B","x":32,"y":7,"s":1,"i":0},{
"key":"H","x":33,"y":1,"s":1,"i":0},{
"key":"H","x":33,"y":2,"s":1,"i":0},{
"key":"C","x":33,"y":3,"s":1,"i":0},{
"key":"A","x":33,"y":4,"s":1,"i":0},{
"key":"A","x":33,"y":5,"s":1,"i":0},{
"key":"B","x":33,"y":6,"s":1,"i":0},{
"key":"H","x":33,"y":7,"s":1,"i":0},{
"key":"H","x":33,"y":8,"s":1,"i":0},{
"key":"H","x":34,"y":1,"s":1,"i":0},{
"key":"H","x":34,"y":3,"s":1,"i":0},{
"key":"B","x":34,"y":4,"s":1,"i":0},{
"key":"B","x":34,"y":5,"s":1,"i":0},{
"key":"C","x":34,"y":6,"s":1,"i":0},{
"key":"H","x":34,"y":7,"s":1,"i":0},{
"key":"H","x":34,"y":9,"s":1,"i":0},{
"key":"H","x":35,"y":1,"s":1,"i":0},{
"key":"H","x":35,"y":2,"s":1,"i":0},{
"key":"A","x":35,"y":4,"s":1,"i":0},{
"key":"C","x":35,"y":5,"s":1,"i":0},{
"key":"H","x":35,"y":7,"s":1,"i":0},{
"key":"H","x":35,"y":8,"s":1,"i":0},{
"key":"A","x":36,"y":5,"s":1,"i":0}],"sub
":[{
"key":"S","x":2,"y":2,"s":0,"i":0},{
"key":"S","x":2,"y":8,"s":0,"i":0},{
"key":"S","x":4,"y":1,"s":0,"i":0},{
"key":"S","x":4,"y":9,"s":0,"i":0},{
"key":"S","x":6,"y":2,"s":0,"i":0},{
"key":"S","x":6,"y":8,"s":0,"i":0},{
"key":"S","x":11,"y":1,"s":0,"i":0},{
"key":"S","x":11,"y":8,"s":0,"i":0},{
"key":"S","x":12,"y":2,"s":0,"i":0},{
"key":"S","x":12,"y":8,"s":0,"i":0},{
"key":"S","x":13,"y":0,"s":0,"i":0},{
"key":"S","x":13,"y":1,"s":0,"i":0},{
"key":"S","x":13,"y":2,"s":0,"i":0},{
"key":"S","x":13,"y":7,"s":0,"i":0},{
"key":"S","x":13,"y":8,"s":0,"i":0},{
"key":"S","x":13,"y":9,"s":0,"i":0},{
"key":"S","x":14,"y":3,"s":0,"i":0},{
"key":"L","x":14,"y":4,"s":0,"i":0},{
"key":"Suo","x":14,"y":5,"s":0,"i":0},{
"key":"L","x":14,"y":6,"s":0,"i":0},{
"key":"S","x":14,"y":7,"s":0,"i":0},{
"key":"S","x":15,"y":1,"s":0,"i":0},{
"key":"S","x":15,"y":3,"s":0,"i":0},{
"key":"S","x":15,"y":6,"s":0,"i":0},{
"key":"S","x":15,"y":8,"s":0,"i":0},{
"key":"S","x":16,"y":2,"s":0,"i":0},{
"key":"S","x":16,"y":3,"s":0,"i":0},{
"key":"S","x":16,"y":7,"s":0,"i":0},{
"key":"S","x":16,"y":8,"s":0,"i":0},{
"key":"L","x":20,"y":0,"s":0,"i":0},{
"key":"L","x":20,"y":1,"s":0,"i":0},{
"key":"Suo","x":20,"y":2,"s":0,"i":0},{
"key":"L","x":20,"y":3,"s":0,"i":0},{
"key":"L","x":20,"y":4,"s":0,"i":0},{
"key":"L","x":20,"y":6,"s":0,"i":0},{
"key":"L","x":20,"y":7,"s":0,"i":0},{
"key":"Suo","x":20,"y":8,"s":0,"i":0},{
"key":"L","x":20,"y":9,"s":0,"i":0},{
"key":"L","x":20,"y":10,"s":0,"i":0},{
"key":"S","x":22,"y":5,"s":0,"i":0},{
"key":"S","x":23,"y":4,"s":0,"i":0},{
"key":"S","x":23,"y":5,"s":0,"i":0},{
"key":"S","x":24,"y":5,"s":0,"i":0},{
"key":"S","x":26,"y":3,"s":0,"i":0},{
"key":"S","x":26,"y":7,"s":0,"i":0},{
"key":"S","x":28,"y":2,"s":0,"i":0},{
"key":"S","x":28,"y":4,"s":0,"i":0},{
"key":"S","x":28,"y":6,"s":0,"i":0},{
"key":"S","x":28,"y":8,"s":0,"i":0},{
"key":"S","x":29,"y":1,"s":0,"i":0},{
"key":"S","x":29,"y":2,"s":0,"i":0},{
"key":"S","x":29,"y":4,"s":0,"i":0},{
"key":"S","x":29,"y":5,"s":0,"i":0},{
"key":"S","x":29,"y":7,"s":0,"i":0},{
"key":"S","x":29,"y":8,"s":0,"i":0},{
"key":"S","x":30,"y":2,"s":0,"i":0},{
"key":"S","x":30,"y":4,"s":0,"i":0},{
"key":"S","x":30,"y":6,"s":0,"i":0},{
"key":"S","x":30,"y":8,"s":0,"i":0},{
"key":"S","x":32,"y":3,"s":0,"i":0},{
"key":"S","x":32,"y":7,"s":0,"i":0},{
"key":"S","x":34,"y":5,"s":0,"i":0},{
"key":"S","x":35,"y":4,"s":0,"i":0},{
"key":"S","x":35,"y":5,"s":0,"i":0},{
"key":"S","x":36,"y":5,"s":0,"i":0}]}