{
"BackCround":{
"backCround_type":1,"bottom_type":2,"skill_type":0},"level":817,"mode":1,"LevelType":{
"Key":"@","Type":1,"Number":1},"Star":{
"star1":321,"star2":33000,"star3":100000},"Gang":{
"Gang1":0,"Gang2":0,"Gang3":0,"Gang4":1,"Gang5":0},"ReadyBubble":{
"R1":0,"R2":0,"R3":0,"R4":0},"BallNumber":38,"TimeLimit":0,"ObjChance":[{
"Key":"C","P":1},{
"Key":"A","P":1},{
"Key":"B","P":1},{
"Key":"E","P":1},{
"Key":"D","P":1}],"top":[],"bubble
":[{
"key":"I","x":0,"y":0,"s":1,"i":0},{
"key":"I","x":0,"y":2,"s":1,"i":0},{
"key":"@","x":0,"y":4,"s":1,"i":0},{
"key":"CJ","x":0,"y":5,"s":1,"i":0},{
"key":"@","x":0,"y":6,"s":1,"i":0},{
"key":"I","x":0,"y":8,"s":1,"i":0},{
"key":"I","x":0,"y":10,"s":1,"i":0},{
"key":"I","x":1,"y":0,"s":1,"i":0},{
"key":"I","x":1,"y":2,"s":1,"i":0},{
"key":"@","x":1,"y":3,"s":1,"i":0},{
"key":"F","x":1,"y":4,"s":1,"i":0},{
"key":"F","x":1,"y":5,"s":1,"i":0},{
"key":"@","x":1,"y":6,"s":1,"i":0},{
"key":"I","x":1,"y":7,"s":1,"i":0},{
"key":"I","x":1,"y":9,"s":1,"i":0},{
"key":"I","x":2,"y":1,"s":1,"i":0},{
"key":"@","x":2,"y":3,"s":1,"i":0},{
"key":"F","x":2,"y":4,"s":1,"i":0},{
"key":"@","x":2,"y":5,"s":1,"i":0},{
"key":"F","x":2,"y":6,"s":1,"i":0},{
"key":"@","x":2,"y":7,"s":1,"i":0},{
"key":"I","x":2,"y":9,"s":1,"i":0},{
"key":"@","x":3,"y":1,"s":1,"i":0},{
"key":"@","x":3,"y":3,"s":1,"i":0},{
"key":"F","x":3,"y":4,"s":1,"i":0},{
"key":"F","x":3,"y":5,"s":1,"i":0},{
"key":"@","x":3,"y":6,"s":1,"i":0},{
"key":"@","x":3,"y":8,"s":1,"i":0},{
"key":"@","x":4,"y":1,"s":1,"i":0},{
"key":"@","x":4,"y":2,"s":1,"i":0},{
"key":"I","x":4,"y":4,"s":1,"i":0},{
"key":"I","x":4,"y":6,"s":1,"i":0},{
"key":"@","x":4,"y":8,"s":1,"i":0},{
"key":"@","x":4,"y":9,"s":1,"i":0},{
"key":"@","x":5,"y":0,"s":1,"i":0},{
"key":"C1","x":5,"y":1,"s":1,"i":0},{
"key":"@","x":5,"y":2,"s":1,"i":0},{
"key":"I","x":5,"y":4,"s":1,"i":0},{
"key":"I","x":5,"y":5,"s":1,"i":0},{
"key":"@","x":5,"y":7,"s":1,"i":0},{
"key":"B1","x":5,"y":8,"s":1,"i":0},{
"key":"@","x":5,"y":9,"s":1,"i":0},{
"key":"@","x":6,"y":0,"s":1,"i":0},{
"key":"A1","x":6,"y":1,"s":1,"i":0},{
"key":"B1","x":6,"y":2,"s":1,"i":0},{
"key":"@","x":6,"y":3,"s":1,"i":0},{
"key":"I","x":6,"y":5,"s":1,"i":0},{
"key":"@","x":6,"y":7,"s":1,"i":0},{
"key":"C1","x":6,"y":8,"s":1,"i":0},{
"key":"A1","x":6,"y":9,"s":1,"i":0},{
"key":"@","x":6,"y":10,"s":1,"i":0},{
"key":"@","x":7,"y":0,"s":1,"i":0},{
"key":"E1","x":7,"y":1,"s":1,"i":0},{
"key":"@","x":7,"y":2,"s":1,"i":0},{
"key":"@","x":7,"y":3,"s":1,"i":0},{
"key":"@","x":7,"y":6,"s":1,"i":0},{
"key":"@","x":7,"y":7,"s":1,"i":0},{
"key":"D1","x":7,"y":8,"s":1,"i":0},{
"key":"@","x":7,"y":9,"s":1,"i":0},{
"key":"@","x":8,"y":0,"s":1,"i":0},{
"key":"@","x":8,"y":1,"s":1,"i":0},{
"key":"@","x":8,"y":2,"s":1,"i":0},{
"key":"@","x":8,"y":3,"s":1,"i":0},{
"key":"@","x":8,"y":4,"s":1,"i":0},{
"key":"@","x":8,"y":6,"s":1,"i":0},{
"key":"@","x":8,"y":7,"s":1,"i":0},{
"key":"@","x":8,"y":8,"s":1,"i":0},{
"key":"@","x":8,"y":9,"s":1,"i":0},{
"key":"@","x":8,"y":10,"s":1,"i":0},{
"key":"@","x":10,"y":0,"s":1,"i":0},{
"key":"@","x":10,"y":1,"s":1,"i":0},{
"key":"J","x":10,"y":2,"s":1,"i":0},{
"key":"@","x":10,"y":3,"s":1,"i":0},{
"key":"@","x":10,"y":4,"s":1,"i":0},{
"key":"@","x":10,"y":5,"s":1,"i":0},{
"key":"E","x":10,"y":6,"s":1,"i":0},{
"key":"B","x":10,"y":7,"s":1,"i":0},{
"key":"J","x":10,"y":8,"s":1,"i":0},{
"key":"@","x":10,"y":9,"s":1,"i":0},{
"key":"@","x":10,"y":10,"s":1,"i":0},{
"key":"@","x":11,"y":0,"s":1,"i":0},{
"key":"@","x":11,"y":1,"s":1,"i":0},{
"key":"N","x":11,"y":2,"s":1,"i":0},{
"key":"@","x":11,"y":3,"s":1,"i":0},{
"key":"E","x":11,"y":6,"s":1,"i":0},{
"key":"GR","x":11,"y":7,"s":1,"i":0},{
"key":"@","x":11,"y":8,"s":1,"i":0},{
"key":"@","x":11,"y":9,"s":1,"i":0},{
"key":"E","x":12,"y":1,"s":1,"i":0},{
"key":"D","x":12,"y":2,"s":1,"i":0},{
"key":"@","x":12,"y":3,"s":1,"i":0},{
"key":"H","x":12,"y":5,"s":1,"i":0},{
"key":"B","x":12,"y":7,"s":1,"i":0},{
"key":"A","x":12,"y":8,"s":1,"i":0},{
"key":"C","x":12,"y":9,"s":1,"i":0},{
"key":"D","x":13,"y":1,"s":1,"i":0},{
"key":"E","x":13,"y":2,"s":1,"i":0},{
"key":"@","x":13,"y":3,"s":1,"i":0},{
"key":"D","x":13,"y":4,"s":1,"i":0},{
"key":"D","x":13,"y":5,"s":1,"i":0},{
"key":"@","x":13,"y":6,"s":1,"i":0},{
"key":"C","x":13,"y":7,"s":1,"i":0},{
"key":"A","x":13,"y":8,"s":1,"i":0},{
"key":"@","x":14,"y":2,"s":1,"i":0},{
"key":"H","x":14,"y":4,"s":1,"i":0},{
"key":"H","x":14,"y":6,"s":1,"i":0},{
"key":"@","x":14,"y":8,"s":1,"i":0},{
"key":"@","x":15,"y":1,"s":1,"i":0},{
"key":"@","x":15,"y":3,"s":1,"i":0},{
"key":"@","x":15,"y":6,"s":1,"i":0},{
"key":"E","x":15,"y":8,"s":1,"i":0},{
"key":"B","x":16,"y":1,"s":1,"i":0},{
"key":"@","x":16,"y":2,"s":1,"i":0},{
"key":"A","x":16,"y":3,"s":1,"i":0},{
"key":"A","x":16,"y":4,"s":1,"i":0},{
"key":"C","x":16,"y":6,"s":1,"i":0},{
"key":"@","x":16,"y":7,"s":1,"i":0},{
"key":"E","x":16,"y":8,"s":1,"i":0},{
"key":"@","x":16,"y":9,"s":1,"i":0},{
"key":"B","x":17,"y":0,"s":1,"i":0},{
"key":"H","x":17,"y":2,"s":1,"i":0},{
"key":"@","x":17,"y":4,"s":1,"i":0},{
"key":"C","x":17,"y":5,"s":1,"i":0},{
"key":"H","x":17,"y":7,"s":1,"i":0},{
"key":"@","x":17,"y":9,"s":1,"i":0},{
"key":"@","x":18,"y":0,"s":1,"i":0},{
"key":"C","x":18,"y":2,"s":1,"i":0},{
"key":"H","x":18,"y":5,"s":1,"i":0},{
"key":"B","x":18,"y":8,"s":1,"i":0},{
"key":"D","x":18,"y":10,"s":1,"i":0},{
"key":"@","x":19,"y":0,"s":1,"i":0},{
"key":"C","x":19,"y":1,"s":1,"i":0},{
"key":"@","x":19,"y":2,"s":1,"i":0},{
"key":"A","x":19,"y":3,"s":1,"i":0},{
"key":"A","x":19,"y":4,"s":1,"i":0},{
"key":"@","x":19,"y":5,"s":1,"i":0},{
"key":"@","x":19,"y":6,"s":1,"i":0},{
"key":"@","x":19,"y":7,"s":1,"i":0},{
"key":"B","x":19,"y":8,"s":1,"i":0},{
"key":"D","x":19,"y":9,"s":1,"i":0},{
"key":"H","x":20,"y":1,"s":1,"i":0},{
"key":"H","x":20,"y":3,"s":1,"i":0},{
"key":"@","x":20,"y":4,"s":1,"i":0},{
"key":"@","x":20,"y":6,"s":1,"i":0},{
"key":"H","x":20,"y":7,"s":1,"i":0},{
"key":"H","x":20,"y":9,"s":1,"i":0},{
"key":"@","x":21,"y":0,"s":1,"i":0},{
"key":"@","x":21,"y":3,"s":1,"i":0},{
"key":"@","x":21,"y":6,"s":1,"i":0},{
"key":"@","x":21,"y":9,"s":1,"i":0},{
"key":"@","x":22,"y":0,"s":1,"i":0},{
"key":"@","x":22,"y":1,"s":1,"i":0},{
"key":"@","x":22,"y":2,"s":1,"i":0},{
"key":"@","x":22,"y":3,"s":1,"i":0},{
"key":"@","x":22,"y":4,"s":1,"i":0},{
"key":"@","x":22,"y":5,"s":1,"i":0},{
"key":"@","x":22,"y":6,"s":1,"i":0},{
"key":"@","x":22,"y":7,"s":1,"i":0},{
"key":"@","x":22,"y":8,"s":1,"i":0},{
"key":"@","x":22,"y":9,"s":1,"i":0},{
"key":"@","x":22,"y":10,"s":1,"i":0},{
"key":"@","x":23,"y":0,"s":1,"i":0},{
"key":"F","x":23,"y":1,"s":1,"i":0},{
"key":"F","x":23,"y":2,"s":1,"i":0},{
"key":"F","x":23,"y":3,"s":1,"i":0},{
"key":"@","x":23,"y":4,"s":1,"i":0},{
"key":"@","x":23,"y":5,"s":1,"i":0},{
"key":"F","x":23,"y":6,"s":1,"i":0},{
"key":"F","x":23,"y":7,"s":1,"i":0},{
"key":"F","x":23,"y":8,"s":1,"i":0},{
"key":"@","x":23,"y":9,"s":1,"i":0},{
"key":"@","x":24,"y":1,"s":1,"i":0},{
"key":"F","x":24,"y":2,"s":1,"i":0},{
"key":"F","x":24,"y":3,"s":1,"i":0},{
"key":"@","x":24,"y":4,"s":1,"i":0},{
"key":"@","x":24,"y":6,"s":1,"i":0},{
"key":"F","x":24,"y":7,"s":1,"i":0},{
"key":"F","x":24,"y":8,"s":1,"i":0},{
"key":"@","x":24,"y":9,"s":1,"i":0},{
"key":"@","x":25,"y":1,"s":1,"i":0},{
"key":"F","x":25,"y":2,"s":1,"i":0},{
"key":"@","x":25,"y":3,"s":1,"i":0},{
"key":"@","x":25,"y":6,"s":1,"i":0},{
"key":"F","x":25,"y":7,"s":1,"i":0},{
"key":"@","x":25,"y":8,"s":1,"i":0},{
"key":"@","x":26,"y":2,"s":1,"i":0},{
"key":"@","x":26,"y":3,"s":1,"i":0},{
"key":"@","x":26,"y":7,"s":1,"i":0},{
"key":"@","x":26,"y":8,"s":1,"i":0},{
"key":"@","x":27,"y":2,"s":1,"i":0},{
"key":"@","x":27,"y":7,"s":1,"i":0}],"sub
":[{
"key":"S","x":22,"y":0,"s":0,"i":0},{
"key":"S","x":22,"y":1,"s":0,"i":0},{
"key":"S","x":22,"y":2,"s":0,"i":0},{
"key":"S","x":22,"y":3,"s":0,"i":0},{
"key":"S","x":22,"y":4,"s":0,"i":0},{
"key":"S","x":22,"y":5,"s":0,"i":0},{
"key":"S","x":22,"y":6,"s":0,"i":0},{
"key":"S","x":22,"y":7,"s":0,"i":0},{
"key":"S","x":22,"y":8,"s":0,"i":0},{
"key":"S","x":22,"y":9,"s":0,"i":0},{
"key":"S","x":22,"y":10,"s":0,"i":0},{
"key":"S","x":23,"y":0,"s":0,"i":0},{
"key":"S","x":23,"y":4,"s":0,"i":0},{
"key":"S","x":23,"y":5,"s":0,"i":0},{
"key":"S","x":23,"y":9,"s":0,"i":0},{
"key":"S","x":24,"y":1,"s":0,"i":0},{
"key":"S","x":24,"y":4,"s":0,"i":0},{
"key":"S","x":24,"y":6,"s":0,"i":0},{
"key":"S","x":24,"y":9,"s":0,"i":0},{
"key":"S","x":25,"y":1,"s":0,"i":0},{
"key":"S","x":25,"y":3,"s":0,"i":0},{
"key":"S","x":25,"y":6,"s":0,"i":0},{
"key":"S","x":25,"y":8,"s":0,"i":0},{
"key":"S","x":26,"y":2,"s":0,"i":0},{
"key":"S","x":26,"y":3,"s":0,"i":0},{
"key":"S","x":26,"y":7,"s":0,"i":0},{
"key":"S","x":26,"y":8,"s":0,"i":0},{
"key":"S","x":27,"y":2,"s":0,"i":0},{
"key":"S","x":27,"y":7,"s":0,"i":0}]}