{
"BackCround":{
"backCround_type":1,"bottom_type":2,"skill_type":0},"level":471,"mode":1,"LevelType":{
"Key":"@","Type":1,"Number":6},"Star":{
"star1":120,"star2":55555,"star3":63000},"Gang":{
"Gang1":0,"Gang2":0,"Gang3":0,"Gang4":1,"Gang5":0},"ReadyBubble":{
"R1":0,"R2":0,"R3":0,"R4":0},"BallNumber":35,"TimeLimit":0,"ObjChance":[{
"Key":"C","P":4},{
"Key":"A","P":4},{
"Key":"B","P":4}],"top":[],"bubble
":[{
"key":"C1","x":0,"y":0,"s":1,"i":0},{
"key":"AJ","x":0,"y":1,"s":1,"i":0},{
"key":"AJ","x":0,"y":5,"s":1,"i":0},{
"key":"CJ","x":0,"y":9,"s":1,"i":0},{
"key":"A1","x":0,"y":10,"s":1,"i":0},{
"key":"A1","x":1,"y":0,"s":1,"i":0},{
"key":"C1","x":1,"y":1,"s":1,"i":0},{
"key":"C1","x":1,"y":4,"s":1,"i":0},{
"key":"B1","x":1,"y":5,"s":1,"i":0},{
"key":"B1","x":1,"y":8,"s":1,"i":0},{
"key":"C1","x":1,"y":9,"s":1,"i":0},{
"key":"C1","x":2,"y":1,"s":1,"i":0},{
"key":"B1","x":2,"y":2,"s":1,"i":0},{
"key":"B1","x":2,"y":4,"s":1,"i":0},{
"key":"A1","x":2,"y":5,"s":1,"i":0},{
"key":"B1","x":2,"y":6,"s":1,"i":0},{
"key":"C1","x":2,"y":8,"s":1,"i":0},{
"key":"A1","x":2,"y":9,"s":1,"i":0},{
"key":"B1","x":3,"y":1,"s":1,"i":0},{
"key":"A1","x":3,"y":2,"s":1,"i":0},{
"key":"C1","x":3,"y":3,"s":1,"i":0},{
"key":"CJ","x":3,"y":4,"s":1,"i":0},{
"key":"C1","x":3,"y":5,"s":1,"i":0},{
"key":"A1","x":3,"y":6,"s":1,"i":0},{
"key":"B1","x":3,"y":7,"s":1,"i":0},{
"key":"A1","x":3,"y":8,"s":1,"i":0},{
"key":"BJ","x":4,"y":2,"s":1,"i":0},{
"key":"A1","x":4,"y":3,"s":1,"i":0},{
"key":"C1","x":4,"y":4,"s":1,"i":0},{
"key":"B1","x":4,"y":6,"s":1,"i":0},{
"key":"C1","x":4,"y":7,"s":1,"i":0},{
"key":"BJ","x":4,"y":8,"s":1,"i":0},{
"key":"A1","x":5,"y":2,"s":1,"i":0},{
"key":"C1","x":5,"y":3,"s":1,"i":0},{
"key":"B1","x":5,"y":6,"s":1,"i":0},{
"key":"A1","x":5,"y":7,"s":1,"i":0},{
"key":"B1","x":6,"y":3,"s":1,"i":0},{
"key":"K","x":6,"y":4,"s":1,"i":0},{
"key":"K","x":6,"y":6,"s":1,"i":0},{
"key":"C1","x":6,"y":7,"s":1,"i":0},{
"key":"@","x":7,"y":0,"s":1,"i":0},{
"key":"@","x":7,"y":1,"s":1,"i":0},{
"key":"C","x":7,"y":2,"s":1,"i":0},{
"key":"@","x":7,"y":3,"s":1,"i":0},{
"key":"H","x":7,"y":4,"s":1,"i":0},{
"key":"H","x":7,"y":5,"s":1,"i":0},{
"key":"@","x":7,"y":6,"s":1,"i":0},{
"key":"A","x":7,"y":7,"s":1,"i":0},{
"key":"@","x":7,"y":8,"s":1,"i":0},{
"key":"@","x":7,"y":9,"s":1,"i":0},{
"key":"A","x":8,"y":3,"s":1,"i":0},{
"key":"K","x":8,"y":4,"s":1,"i":0},{
"key":"K","x":8,"y":6,"s":1,"i":0},{
"key":"B","x":8,"y":7,"s":1,"i":0},{
"key":"A","x":9,"y":2,"s":1,"i":0},{
"key":"A","x":9,"y":3,"s":1,"i":0},{
"key":"B","x":9,"y":6,"s":1,"i":0},{
"key":"B","x":9,"y":7,"s":1,"i":0},{
"key":"A","x":10,"y":2,"s":1,"i":0},{
"key":"C","x":10,"y":3,"s":1,"i":0},{
"key":"A","x":10,"y":4,"s":1,"i":0},{
"key":"B","x":10,"y":6,"s":1,"i":0},{
"key":"C","x":10,"y":7,"s":1,"i":0},{
"key":"B","x":10,"y":8,"s":1,"i":0},{
"key":"A","x":11,"y":1,"s":1,"i":0},{
"key":"C","x":11,"y":2,"s":1,"i":0},{
"key":"C","x":11,"y":3,"s":1,"i":0},{
"key":"A","x":11,"y":4,"s":1,"i":0},{
"key":"B","x":11,"y":5,"s":1,"i":0},{
"key":"C","x":11,"y":6,"s":1,"i":0},{
"key":"C","x":11,"y":7,"s":1,"i":0},{
"key":"B","x":11,"y":8,"s":1,"i":0},{
"key":"A","x":12,"y":1,"s":1,"i":0},{
"key":"C","x":12,"y":2,"s":1,"i":0},{
"key":"C","x":12,"y":4,"s":1,"i":0},{
"key":"K","x":12,"y":5,"s":1,"i":0},{
"key":"C","x":12,"y":6,"s":1,"i":0},{
"key":"C","x":12,"y":8,"s":1,"i":0},{
"key":"B","x":12,"y":9,"s":1,"i":0},{
"key":"A","x":13,"y":0,"s":1,"i":0},{
"key":"C","x":13,"y":1,"s":1,"i":0},{
"key":"C","x":13,"y":4,"s":1,"i":0},{
"key":"C","x":13,"y":5,"s":1,"i":0},{
"key":"C","x":13,"y":8,"s":1,"i":0},{
"key":"B","x":13,"y":9,"s":1,"i":0},{
"key":"C","x":14,"y":0,"s":1,"i":0},{
"key":"C","x":14,"y":1,"s":1,"i":0},{
"key":"C","x":14,"y":5,"s":1,"i":0},{
"key":"C","x":14,"y":9,"s":1,"i":0},{
"key":"C","x":14,"y":10,"s":1,"i":0},{
"key":"H","x":15,"y":0,"s":1,"i":0},{
"key":"H","x":15,"y":9,"s":1,"i":0},{
"key":"H","x":16,"y":1,"s":1,"i":0},{
"key":"H","x":16,"y":2,"s":1,"i":0},{
"key":"H","x":16,"y":3,"s":1,"i":0},{
"key":"H","x":16,"y":4,"s":1,"i":0},{
"key":"A","x":16,"y":5,"s":1,"i":0},{
"key":"H","x":16,"y":6,"s":1,"i":0},{
"key":"H","x":16,"y":7,"s":1,"i":0},{
"key":"H","x":16,"y":8,"s":1,"i":0},{
"key":"H","x":16,"y":9,"s":1,"i":0},{
"key":"B","x":17,"y":1,"s":1,"i":0},{
"key":"B","x":17,"y":2,"s":1,"i":0},{
"key":"C","x":17,"y":4,"s":1,"i":0},{
"key":"C","x":17,"y":5,"s":1,"i":0},{
"key":"A","x":17,"y":7,"s":1,"i":0},{
"key":"A","x":17,"y":8,"s":1,"i":0},{
"key":"H","x":18,"y":2,"s":1,"i":0},{
"key":"A","x":18,"y":3,"s":1,"i":0},{
"key":"C","x":18,"y":4,"s":1,"i":0},{
"key":"A","x":18,"y":6,"s":1,"i":0},{
"key":"C","x":18,"y":7,"s":1,"i":0},{
"key":"H","x":18,"y":8,"s":1,"i":0},{
"key":"H","x":19,"y":2,"s":1,"i":0},{
"key":"@","x":19,"y":3,"s":1,"i":0},{
"key":"B","x":19,"y":4,"s":1,"i":0},{
"key":"C","x":19,"y":5,"s":1,"i":0},{
"key":"A","x":19,"y":6,"s":1,"i":0},{
"key":"H","x":19,"y":7,"s":1,"i":0},{
"key":"@","x":20,"y":3,"s":1,"i":0},{
"key":"B","x":20,"y":4,"s":1,"i":0},{
"key":"C","x":20,"y":5,"s":1,"i":0},{
"key":"B","x":20,"y":6,"s":1,"i":0},{
"key":"@","x":20,"y":7,"s":1,"i":0},{
"key":"H","x":21,"y":3,"s":1,"i":0},{
"key":"B","x":21,"y":4,"s":1,"i":0},{
"key":"B","x":21,"y":5,"s":1,"i":0},{
"key":"H","x":21,"y":6,"s":1,"i":0},{
"key":"H","x":22,"y":4,"s":1,"i":0},{
"key":"H","x":22,"y":6,"s":1,"i":0},{
"key":"A","x":23,"y":4,"s":1,"i":0},{
"key":"A","x":23,"y":5,"s":1,"i":0},{
"key":"H","x":24,"y":5,"s":1,"i":0},{
"key":"H","x":25,"y":4,"s":1,"i":0},{
"key":"H","x":25,"y":5,"s":1,"i":0},{
"key":"@","x":26,"y":4,"s":1,"i":0},{
"key":"@","x":26,"y":5,"s":1,"i":0},{
"key":"@","x":26,"y":6,"s":1,"i":0},{
"key":"@","x":27,"y":3,"s":1,"i":0},{
"key":"@","x":27,"y":4,"s":1,"i":0},{
"key":"@","x":27,"y":5,"s":1,"i":0},{
"key":"@","x":27,"y":6,"s":1,"i":0},{
"key":"@","x":28,"y":3,"s":1,"i":0},{
"key":"@","x":28,"y":4,"s":1,"i":0},{
"key":"@","x":28,"y":5,"s":1,"i":0},{
"key":"@","x":28,"y":6,"s":1,"i":0},{
"key":"@","x":28,"y":7,"s":1,"i":0},{
"key":"@","x":29,"y":3,"s":1,"i":0},{
"key":"@","x":29,"y":4,"s":1,"i":0},{
"key":"@","x":29,"y":5,"s":1,"i":0},{
"key":"@","x":29,"y":6,"s":1,"i":0},{
"key":"@","x":30,"y":4,"s":1,"i":0},{
"key":"@","x":30,"y":5,"s":1,"i":0},{
"key":"@","x":30,"y":6,"s":1,"i":0},{
"key":"H","x":31,"y":0,"s":1,"i":0},{
"key":"H","x":31,"y":1,"s":1,"i":0},{
"key":"H","x":31,"y":2,"s":1,"i":0},{
"key":"H","x":31,"y":3,"s":1,"i":0},{
"key":"G","x":31,"y":4,"s":1,"i":0},{
"key":"G","x":31,"y":5,"s":1,"i":0},{
"key":"H","x":31,"y":6,"s":1,"i":0},{
"key":"H","x":31,"y":7,"s":1,"i":0},{
"key":"H","x":31,"y":8,"s":1,"i":0},{
"key":"H","x":31,"y":9,"s":1,"i":0},{
"key":"@","x":32,"y":4,"s":1,"i":0},{
"key":"@","x":32,"y":5,"s":1,"i":0},{
"key":"@","x":32,"y":6,"s":1,"i":0},{
"key":"@","x":33,"y":3,"s":1,"i":0},{
"key":"@","x":33,"y":4,"s":1,"i":0},{
"key":"@","x":33,"y":5,"s":1,"i":0},{
"key":"@","x":33,"y":6,"s":1,"i":0},{
"key":"@","x":34,"y":3,"s":1,"i":0},{
"key":"@","x":34,"y":4,"s":1,"i":0},{
"key":"@","x":34,"y":5,"s":1,"i":0},{
"key":"@","x":34,"y":6,"s":1,"i":0},{
"key":"@","x":34,"y":7,"s":1,"i":0},{
"key":"@","x":35,"y":3,"s":1,"i":0},{
"key":"@","x":35,"y":4,"s":1,"i":0},{
"key":"@","x":35,"y":5,"s":1,"i":0},{
"key":"@","x":35,"y":6,"s":1,"i":0},{
"key":"@","x":36,"y":4,"s":1,"i":0},{
"key":"@","x":36,"y":5,"s":1,"i":0},{
"key":"@","x":36,"y":6,"s":1,"i":0},{
"key":"H","x":37,"y":0,"s":1,"i":0},{
"key":"H","x":37,"y":1,"s":1,"i":0},{
"key":"H","x":37,"y":2,"s":1,"i":0},{
"key":"H","x":37,"y":3,"s":1,"i":0},{
"key":"G","x":37,"y":4,"s":1,"i":0},{
"key":"G","x":37,"y":5,"s":1,"i":0},{
"key":"H","x":37,"y":6,"s":1,"i":0},{
"key":"H","x":37,"y":7,"s":1,"i":0},{
"key":"H","x":37,"y":8,"s":1,"i":0},{
"key":"H","x":37,"y":9,"s":1,"i":0},{
"key":"@","x":38,"y":4,"s":1,"i":0},{
"key":"@","x":38,"y":5,"s":1,"i":0},{
"key":"@","x":38,"y":6,"s":1,"i":0},{
"key":"@","x":39,"y":3,"s":1,"i":0},{
"key":"@","x":39,"y":4,"s":1,"i":0},{
"key":"@","x":39,"y":5,"s":1,"i":0},{
"key":"@","x":39,"y":6,"s":1,"i":0},{
"key":"@","x":40,"y":3,"s":1,"i":0},{
"key":"@","x":40,"y":4,"s":1,"i":0},{
"key":"@","x":40,"y":5,"s":1,"i":0},{
"key":"@","x":40,"y":6,"s":1,"i":0},{
"key":"@","x":40,"y":7,"s":1,"i":0},{
"key":"@","x":41,"y":3,"s":1,"i":0},{
"key":"@","x":41,"y":4,"s":1,"i":0},{
"key":"@","x":41,"y":5,"s":1,"i":0},{
"key":"@","x":41,"y":6,"s":1,"i":0},{
"key":"@","x":42,"y":4,"s":1,"i":0},{
"key":"@","x":42,"y":5,"s":1,"i":0},{
"key":"@","x":42,"y":6,"s":1,"i":0}],"sub
":[{
"key":"L","x":7,"y":0,"s":0,"i":0},{
"key":"L","x":7,"y":1,"s":0,"i":0},{
"key":"Suo","x":7,"y":2,"s":0,"i":0},{
"key":"L","x":7,"y":3,"s":0,"i":0},{
"key":"L","x":7,"y":6,"s":0,"i":0},{
"key":"Suo","x":7,"y":7,"s":0,"i":0},{
"key":"L","x":7,"y":8,"s":0,"i":0},{
"key":"L","x":7,"y":9,"s":0,"i":0},{
"key":"L","x":20,"y":3,"s":0,"i":0},{
"key":"L","x":20,"y":4,"s":0,"i":0},{
"key":"Suo","x":20,"y":5,"s":0,"i":0},{
"key":"L","x":20,"y":6,"s":0,"i":0},{
"key":"L","x":20,"y":7,"s":0,"i":0},{
"key":"L","x":26,"y":4,"s":0,"i":0},{
"key":"Suo","x":26,"y":5,"s":0,"i":0},{
"key":"L","x":26,"y":6,"s":0,"i":0},{
"key":"L","x":28,"y":3,"s":0,"i":0},{
"key":"L","x":28,"y":4,"s":0,"i":0},{
"key":"Suo","x":28,"y":5,"s":0,"i":0},{
"key":"L","x":28,"y":6,"s":0,"i":0},{
"key":"L","x":28,"y":7,"s":0,"i":0},{
"key":"L","x":30,"y":4,"s":0,"i":0},{
"key":"Suo","x":30,"y":5,"s":0,"i":0},{
"key":"L","x":30,"y":6,"s":0,"i":0},{
"key":"L","x":32,"y":4,"s":0,"i":0},{
"key":"Suo","x":32,"y":5,"s":0,"i":0},{
"key":"L","x":32,"y":6,"s":0,"i":0},{
"key":"L","x":34,"y":3,"s":0,"i":0},{
"key":"L","x":34,"y":4,"s":0,"i":0},{
"key":"Suo","x":34,"y":5,"s":0,"i":0},{
"key":"L","x":34,"y":6,"s":0,"i":0},{
"key":"L","x":34,"y":7,"s":0,"i":0},{
"key":"L","x":36,"y":4,"s":0,"i":0},{
"key":"Suo","x":36,"y":5,"s":0,"i":0},{
"key":"L","x":36,"y":6,"s":0,"i":0},{
"key":"L","x":38,"y":4,"s":0,"i":0},{
"key":"Suo","x":38,"y":5,"s":0,"i":0},{
"key":"L","x":38,"y":6,"s":0,"i":0},{
"key":"L","x":40,"y":3,"s":0,"i":0},{
"key":"L","x":40,"y":4,"s":0,"i":0},{
"key":"Suo","x":40,"y":5,"s":0,"i":0},{
"key":"L","x":40,"y":6,"s":0,"i":0},{
"key":"L","x":40,"y":7,"s":0,"i":0},{
"key":"L","x":42,"y":4,"s":0,"i":0},{
"key":"Suo","x":42,"y":5,"s":0,"i":0},{
"key":"L","x":42,"y":6,"s":0,"i":0}],"down
":[],"jysub

":[]}